You wake up from a quick nap in your office. You look around - you clearly haven't cleaned it in a while. How could you, with the biggest case you've ever faced still unsolved?

Detective Afonzo and The Cult of La Mancha
An Interactive Fiction by Alien Cat Studios
Release 1 / Serial number 260524 / Inform 7 v10.1.2 / D

Office
My office, where I've solved so many crimes... but now I face my biggest mystery.

You can see a desk, a closet and a rack (on which are a green hat, a red hat, a black hat, a tiara and a trophy) here.

>clean the desk
There we go, I got rid of all the junk now!

* * *

You wake up from a quick nap in your office. You look around - you clearly haven't cleaned it in a while. How could you, with the biggest case you've ever faced still unsolved?

Detective Afonzo and The Cult of La Mancha
An Interactive Fiction by Alien Cat Studios
Release 1 / Serial number 260524 / Inform 7 v10.1.2 / D

Office
My office, where I've solved so many crimes... but now I face my biggest mystery.

You can see a desk, a closet and a rack (on which are a green hat, a red hat, a black hat, a tiara and a trophy) here.

>examine desk
My desk is a mess... I really need to clean this up...

* * *

>examine desk
My desk is spotless now!

On the desk are a doctor's note, an old newspaper and a tablet.

>examine doctor's note
You see nothing special about the doctor's note.

>examine old newspaper
A newspaper from 2 weeks ago with a disturbing front page... "Corruption may win - João and Maria Alfonzo found dead in a dark alley". How can't I remember that day?
...
My parents were pretty important in stopping the corruption in this city... I'm sure a lot of people would want them dead. It's not surprising this is in the cover of the newspaper... but I will find out who did this!

>read doctor's note
You see nothing special about the doctor's note.

* * *

>examine doctor's note
You see nothing special about the doctor's note.

>go outside
The 68th Street

* * *

You wake up from a quick nap in your office. You look around - you clearly haven't cleaned it in a while. How could you, with the biggest case you've ever faced still unsolved?

Detective Afonzo and The Cult of La Mancha
An Interactive Fiction by Alien Cat Studios
Release 1 / Serial number 260524 / Inform 7 v10.1.2 / D

Office
My office, where I've solved so many crimes... but now I face my biggest mystery.

You can see a desk, a closet and a rack (on which are a green hat, a red hat, a black hat, a tiara and a trophy) here.

>examine the desk
My desk is a mess... I really need to clean this up...