You wake up from a quick nap in your office. You look around - you clearly haven't cleaned it in a while. How could you, with the biggest case you've ever faced still unsolved?

Detective Afonzo and The Cult of La Mancha
An Interactive Fiction by Alien Cat Studios
Release 1 / Serial number 260530 / Inform 7 v10.1.2 / D

Office
 My dusty old office, I've solved so many crimes here... but none like the mystery im facing now.

You can see a desk, a closet (closed) and a rack (on which are a green hat, a red hat, a black hat, a tiara and a trophy) here.

>Open closet
What a mess... well, look what we have here... this pile of paper has my current cases, and it's piling up... I should take a look at these.

>Look at cases
You can't see any such thing.

>Look at pile of paper
There are 2 cases here. Another couple just like my parents, found in Bingo Street... and a judge killed in his own chambers. He was working on some case about a cosmetics company.

>Go to Bingo Street
You can't see any such thing.

>Travel to Bingo Street
That's not a verb I recognise.

>Look at desk
My desk is a mess... I really need to clean this up...

>Clean desk
There we go, I got rid of all the junk now!

>Dirty desk
That's not a verb I recognise.

>Look at desk
My desk is spotless now!

On the desk are a doctor's note, an old newspaper and a tablet.

>Look at doctor's note
A note from an appointment that reads: "severe case of amnesia, causing a memory loss of the past 2 weeks.". It's all a fog to me.

>Read newspaper
My parents were pretty important in stopping the corruption in this city... I'm sure a lot of people would want them dead. It's not surprising this is in the cover of the newspaper... but I will find out who did this!

>Use tablet
That's not a verb I recognise.

>Look at tablet
A tablet where I keep my diary... but for some reason the past 2 weeks have been erased... precisely the time I lost my memory... stupid thing, the first time it would actually be useful I forgot to write in it!

>Look at trophy
I was so good at Mark Kart 64... winning this tournament was a breeze!

>Look at tiara
It shines so brightly... more than every other hat...

>Wear tiara
(first taking the tiara)
Nobody can question my fashion! I will walk out with a tiara if I want!

I beg your pardon?

>Look at green hat
This hat is perfect for St. Patrick celebrations.

>Leave office
I only understood you as far as wanting to leave.

>Exit office
I only understood you as far as wanting to exit.

>Get out
I could leave, but to where? I should probably read my cases first.

>Go to Bingo Street
You can't see any such thing.

>Exit house
I only understood you as far as wanting to exit.

>Leave house
I only understood you as far as wanting to leave.

>Leave apartment
I only understood you as far as wanting to leave.

>leave office
I only understood you as far as wanting to leave.

>Let me out
That's not a verb I recognise.

>Read cases
You can't see any such thing.

>Look at pile of paper
There are 2 cases here. Another couple just like my parents, found in Bingo Street... and a judge killed in his own chambers. He was working on some case about a cosmetics company.

>Read cases
You can't see any such thing.

>Read pile of paper
The first case happened a week ago... they were found dead in a trash can. According to the police report, they had very peculiar injuries... it looks like they fought with the attacker.
As for the second case, it was just delivered to me. The body is still in the courthouse, so I should head there soon. Judge Richard was found dead in his chambers found with a knife in his head. A judge can get a lot of enemies, but he was only working on one case at the time... I should go there.

>Go to courthouse
You can't see any such thing.

>Go to trash can
You can't see any such thing.

>Leave office
I only understood you as far as wanting to leave.

>Leave house
I only understood you as far as wanting to leave.

>Let me leave
That's not a verb I recognise.

>Leave
The 68th Street
68th Street looks as busy, noisy and smelly as usual. Cars are flying around, ads cover every screen, and people walk and move around in their trendy clothes like ants going to and from their home colonies, living their happy lives mindlessly.

Both murders happened in another part of the town, I think have to go east.

>Go east
St Miku Crossing
St. Miku Crossing, the epitome of modern city living, a sea of people surrounded by cars, shops and buildings as tall as the eye can see, piercing the clouds above like a knife.

>Go to courthouse
You can't see any such thing.

>Go North
You can't go that way.

>Go South
Justice Avenue
Justice Avenue looks as tidy as ever, it's the home of the city's rich and powerful, where the oligarchs and polititians come together to scheme whatever greedy plans they have... and they call it Justice, heh.

The ads here are different, instead of the newest movies and products, it's fine dining and jewelry. Even the people look different, the neon bright colors are now replaced by more sublte, darker tones, the hoodies turn to suits and ties and the smiles to stone cold expressions.

They don't even notice me walk by.

There's multiple ways to go from here, east, to the Daniel Louis-Campbell Park, to the south where the El Court" Americano is and to the west, towards Bingo Street.

You can see a closed park gate that leads to the Daniel Louis-Campbell Park. and Mike here.

>Go to Mike
You can't see any such thing.

>Approach Mike
That's not a verb I recognise.

>Talk to Mike
"I wanted to see the small ducks, but they are under construction..."
...
"I mean the park, not the ducks!
Oh. Ok... I'm just gonna go now...
"Oh ok Mr. High-And-Mighty-Tiara-Wearer. It's not like I'm the only weirdo here!

>Go South
El Court" Americano - Main Hall
I've always loved the look of this place, it's like a beacon of life in the middle of a sea of gray concrete mediocrity. It's a massive square entrance with big glass doors that let the sunshine come in during the day.

The architecture of it somehow strikes a perfect balance between between classic, roman-inspired designs and a smooth, minimalism-heavy futuristic style.

People are walking all over the place with books in their hands, phones in their ears or holding their bags while sprinting somewhere as if they're late. I doubt any of them would talk.

On the far end of the room there's a big reception area, with three spots for receptionists to welcome in visitors and guide them to where they need to go though, at this time, there's only one present, and she looks free to talk to, maybe i could talk to her.

There's something strange to the East, i can see a small door almost completly covered by a group of plants leaning over to it, like they we're placed there to hide it.

You can see a receptionist here.

>Takl to receptionist
That's not a verb I recognise.

>Talk to receptionist
Hello, may I know where Judge Richard's chambers are?
"I'm sorry, but he is quite busy at the moment, you need to return another day."
I am Detective Alfonzo. I was called here to investigate his death.
"My apologies... it's that room to the right."
I thought my hat would give it away...
"Well that... certainly looks nice on you!"

>Go inside
>A strange man bumps into you.
Hey! Watch where you're going!
He's already gone... could have at least apologized.

El Court" Americano - Judge Richard's Office
I remember hearing about this guy from my mother... I think they worked together a couple of times...

This is one small office... looks old, older than the rest of the building, like it's holding on to a long forgotten past.

It's well kept though, despite... everything.

You can see a Fancy Desk (on which is an Open Letter), a Judge Richard's Dead Body, a Blood Stain and a Bookshelf here.

>Examine fancy desk
This desk has some fine craftsmanship, suiting for a judge. Though it's starting to show it's age.

I should take a closer look at it.

On the Fancy Desk is an Open Letter.

>Look at open letter
Hold on, this letter is in my mother's handwritting... looks like they were close, much closer than i thought.

They were working on a case together for her activism, but I can't make out the rest of it though.

>Investigate Judge Richard's Dead Body
That's not a verb I recognise.

>Examine Judge Richard's Dead Body
Poor old bastard. Stabbed in the back of the head, whoever did this wanted to make sure he didn't walk out of here alive.

The knife is missing.

>Examine blood stain
There's a trail of blood leading underneath the bookshelf.

>Examine bookshelf
An old bookshelf, filled to the brim with all kinds of books and memorabilia

>Examine books
You can't see any such thing.

>Move bookshelf
Nothing obvious happens.

>Examine memorabilia
You can't see any such thing.

>Investigate memorabilia
That's not a verb I recognise.

>Look under bookshelf
Under the Bookshelf you find a Bloody Knife.

>Take bloody knife
Taken.

>Investigate bloody knife
That's not a verb I recognise.

>Examine bloody knife
Must be the murder weapon. The blood's gone dry.

There's a symbol of a hand on the handle. The blade looks odd... now that i look at it, this kind of thing could do some real damage if handled improperly, the same kind of damage found on that couple in Bingo Street.

This thing was hiding under the bookshelf... I wonder if there are other hidden things i could find.

>Look under bookshelf
You find nothing of interest.

>Examine under bookshelf
You can't see any such thing.

>Leave
El Court" Americano - Main Hall
I've always loved the look of this place, it's like a beacon of life in the middle of a sea of gray concrete mediocrity. It's a massive square entrance with big glass doors that let the sunshine come in during the day.

The architecture of it somehow strikes a perfect balance between between classic, roman-inspired designs and a smooth, minimalism-heavy futuristic style.

People are walking all over the place with books in their hands, phones in their ears or holding their bags while sprinting somewhere as if they're late. I doubt any of them would talk.

On the far end of the room there's a big reception area, with three spots for receptionists to welcome in visitors and guide them to where they need to go though, at this time, there's only one present, and she looks free to talk to, maybe i could talk to her.

There's something strange to the East, i can see a small door almost completly covered by a group of plants leaning over to it, like they we're placed there to hide it.

You can see a receptionist here.

>Leave
Justice Avenue
Justice Avenue looks as tidy as ever, it's the home of the city's rich and powerful, where the oligarchs and polititians come together to scheme whatever greedy plans they have... and they call it Justice, heh.

The ads here are different, instead of the newest movies and products, it's fine dining and jewelry. Even the people look different, the neon bright colors are now replaced by more sublte, darker tones, the hoodies turn to suits and ties and the smiles to stone cold expressions.

They don't even notice me walk by.

There's multiple ways to go from here, east, to the Daniel Louis-Campbell Park, to the south where the El Court" Americano is and to the west, towards Bingo Street.

You can see a closed park gate that leads to the Daniel Louis-Campbell Park. and Mike here.

>Go West
Bingo Street
Bingo Street is like a louder, more run down version of 68th Street, if that's even possible. The atmosphere feels similar, but the people don't, they feel more like the ones on Justice Avenue, only without all the money.

The cops don't usually come here, they're paid well not to... damn bastards.

For some reason they decided to build a damn company here, i'd go in but the place is in repairs from what it looks like, about time if ya ask me, thought it'd be better if the people got that treatment first, it's been needed for a long ass time.

>Go East
Justice Avenue
Justice Avenue looks as tidy as ever, it's the home of the city's rich and powerful, where the oligarchs and polititians come together to scheme whatever greedy plans they have... and they call it Justice, heh.

The ads here are different, instead of the newest movies and products, it's fine dining and jewelry. Even the people look different, the neon bright colors are now replaced by more sublte, darker tones, the hoodies turn to suits and ties and the smiles to stone cold expressions.

They don't even notice me walk by.

There's multiple ways to go from here, east, to the Daniel Louis-Campbell Park, to the south where the El Court" Americano is and to the west, towards Bingo Street.

You can see a closed park gate that leads to the Daniel Louis-Campbell Park. and Mike here.

>Go South
El Court" Americano - Main Hall
I've always loved the look of this place, it's like a beacon of life in the middle of a sea of gray concrete mediocrity. It's a massive square entrance with big glass doors that let the sunshine come in during the day.

The architecture of it somehow strikes a perfect balance between between classic, roman-inspired designs and a smooth, minimalism-heavy futuristic style.

People are walking all over the place with books in their hands, phones in their ears or holding their bags while sprinting somewhere as if they're late. I doubt any of them would talk.

On the far end of the room there's a big reception area, with three spots for receptionists to welcome in visitors and guide them to where they need to go though, at this time, there's only one present, and she looks free to talk to, maybe i could talk to her.

There's something strange to the East, i can see a small door almost completly covered by a group of plants leaning over to it, like they we're placed there to hide it.

You can see a receptionist here.

>Go inside
El Court" Americano - Judge Richard's Office
I remember hearing about this guy from my mother... I think they worked together a couple of times...

This is one small office... looks old, older than the rest of the building, like it's holding on to a long forgotten past.

It's well kept though, despite... everything.

You can see a Fancy Desk (on which is an Open Letter), a Judge Richard's Dead Body, a Blood Stain and a Bookshelf here.

>Look under desk
Under the Fancy Desk you find an old key.

>Taken old key
That's not a verb I recognise.

>Take old key
A key? I wonder what I could do with this...

Taken.

>Leave
El Court" Americano - Main Hall
I've always loved the look of this place, it's like a beacon of life in the middle of a sea of gray concrete mediocrity. It's a massive square entrance with big glass doors that let the sunshine come in during the day.

The architecture of it somehow strikes a perfect balance between between classic, roman-inspired designs and a smooth, minimalism-heavy futuristic style.

People are walking all over the place with books in their hands, phones in their ears or holding their bags while sprinting somewhere as if they're late. I doubt any of them would talk.

On the far end of the room there's a big reception area, with three spots for receptionists to welcome in visitors and guide them to where they need to go though, at this time, there's only one present, and she looks free to talk to, maybe i could talk to her.

There's something strange to the East, i can see a small door almost completly covered by a group of plants leaning over to it, like they we're placed there to hide it.

You can see a receptionist here.

>Leave
Justice Avenue
Back in the Justice Avenue. Looks like the Park is finally open. Maybe I should go inside and look at the ducks.

You can see a closed park gate that leads to the Daniel Louis-Campbell Park. and Mike here.

>Talk to Mike
"I can finally see the ducks! I'm so excited to finally enter the DLC Park!"

>Enter park
Daniel Louis-Campbell Park
I used to come here as a kid, there was a playground further in where mom and dad used to play catch with me.

Looks like there is a lake here. So pretty.

You can see a closed park gate that leads to the Daniel Louis-Campbell Park. and a lake here.

>Go to gate
You can't see any such thing.

>Open gate
That's already open.

>Investigate lake
That's not a verb I recognise.

>Examine lake
Such a pretty lake, and the ducks are sweet too. I remember throwing stones at the lake to see how many times it would rebound. I don't have any stones, but I have a key...

>Throw key
Dropped.

>Pick up key
A key? I wonder what I could do with this...

Taken.

>Throw key at lake
Oh. It sunk immediatly. Oops.

>script off
Transcripting is already off.

* * *

You wake up from a quick nap in your office. You look around - you clearly haven't cleaned it in a while. How could you, with the biggest case you've ever faced still unsolved?

Detective Afonzo and The Cult of La Mancha
An Interactive Fiction by Alien Cat Studios
Release 1 / Serial number 260530 / Inform 7 v10.1.2 / D

Office
 My dusty old office, I've solved so many crimes here... but none like the mystery im facing now.

You can see a desk, a closet (closed) and a rack (on which are a green hat, a red hat, a black hat, a tiara and a trophy) here.

>clean the desk
There we go, I got rid of all the junk now!

>clean the desk
The desk is already pretty clean!

* * *

>clean the desk
There we go, I got rid of all the junk now!

>cleaning the desk
That's not a verb I recognise.

>examine desk
My desk is a mess... I really need to clean this up...

* * *

>clean the desk
There we go, I got rid of all the junk now!

>examine desk
My desk is a mess... I really need to clean this up...

On the desk are a doctor's note, an old newspaper and a tablet.

* * *

You wake up from a quick nap in your office. You look around - you clearly haven't cleaned it in a while. How could you, with the biggest case you've ever faced still unsolved?

Detective Afonzo and The Cult of La Mancha
An Interactive Fiction by Alien Cat Studios
Release 1 / Serial number 260530 / Inform 7 v10.1.2 / D

Office
 My dusty old office, I've solved so many crimes here... but none like the mystery im facing now.

You can see a desk, a closet (closed) and a rack (on which are a green hat, a red hat, a black hat, a tiara and a trophy) here.

>examine closet
Ain't nothing special "bout this junk.

>open closet
What a mess... well, look what we have here... this pile of paper has my current cases, and it's piling up... I should take a look at these.

>read pile of paper
The first case happened a week ago... they were found dead in a trash can. According to the police report, they had very peculiar injuries... it looks like they fought with the attacker.
As for the second case, it was just delivered to me. The body is still in the courthouse, so I should head there soon. Judge Richard was found dead in his chambers found with a knife in his head. A judge can get a lot of enemies, but he was only working on one case at the time... I should go there.

>exit
It's chilly outside. I should probably wear a hat.

>wear tiara
(first taking the tiara)
Nobody can question my fashion! I will walk out with a tiara if I want!

>exit
The 68th Street
68th Street looks as busy, noisy and smelly as usual. Cars are flying around, ads cover every screen, and people walk and move around in their trendy clothes like ants going to and from their home colonies, living their happy lives mindlessly.

Both murders happened in another part of the town, I think have to go east.

>go e
St Miku Crossing
St. Miku Crossing, the epitome of modern city living, a sea of people surrounded by cars, shops and buildings as tall as the eye can see, piercing the clouds above like a knife.

>go s
Justice Avenue
Justice Avenue looks as tidy as ever, it's the home of the city's rich and powerful, where the oligarchs and polititians come together to scheme whatever greedy plans they have... and they call it Justice, heh.

The ads here are different, instead of the newest movies and products, it's fine dining and jewelry. Even the people look different, the neon bright colors are now replaced by more sublte, darker tones, the hoodies turn to suits and ties and the smiles to stone cold expressions.

They don't even notice me walk by.

There's multiple ways to go from here, east, to the Daniel Louis-Campbell Park, to the south where the El Court" Americano is and to the west, towards Bingo Street.

You can see a closed park gate that leads to the Daniel Louis-Campbell Park. and Mike here.

>go e
(first opening the closed park gate that leads to the Daniel Louis-Campbell Park.)
It's still under construction...

>go s
El Court" Americano - Main Hall
I've always loved the look of this place, it's like a beacon of life in the middle of a sea of gray concrete mediocrity. It's a massive square entrance with big glass doors that let the sunshine come in during the day.

The architecture of it somehow strikes a perfect balance between between classic, roman-inspired designs and a smooth, minimalism-heavy futuristic style.

People are walking all over the place with books in their hands, phones in their ears or holding their bags while sprinting somewhere as if they're late. I doubt any of them would talk.

On the far end of the room there's a big reception area, with three spots for receptionists to welcome in visitors and guide them to where they need to go though, at this time, there's only one present, and she looks free to talk to, maybe i could talk to her.

There's something strange to the East, i can see a small door almost completly covered by a group of plants leaning over to it, like they we're placed there to hide it.

You can see a receptionist here.

>go inside
I don't really know where Judge Richards's chambers are... perhaps I should look for someone who knows.

>talk to lady
Hello, may I know where Judge Richard's chambers are?
"I'm sorry, but he is quite busy at the moment, you need to return another day."
I am Detective Alfonzo. I was called here to investigate his death.
"My apologies... it's that room to the right."
I thought my hat would give it away...
"Well that... certainly looks nice on you!"

>go inside
>A strange man bumps into you.
Hey! Watch where you're going!
He's already gone... could have at least apologized.

El Court" Americano - Judge Richard's Office
I remember hearing about this guy from my mother... I think they worked together a couple of times...

This is one small office... looks old, older than the rest of the building, like it's holding on to a long forgotten past.

It's well kept though, despite... everything.

You can see a Fancy Desk (on which is an Open Letter), a Judge Richard's Dead Body, a Blood Stain and a Bookshelf here.

>take key
You can't see any such thing.

>take old key
You can't see any such thing.

>take the Old Key
You can't see any such thing.

>look around
You can't see any such thing.

>look under fancy desk
Under the Fancy Desk you find an Old Key.

>take old key
A key? I wonder what I could do with this...

Taken.

>exit
El Court" Americano - Main Hall
I've always loved the look of this place, it's like a beacon of life in the middle of a sea of gray concrete mediocrity. It's a massive square entrance with big glass doors that let the sunshine come in during the day.

The architecture of it somehow strikes a perfect balance between between classic, roman-inspired designs and a smooth, minimalism-heavy futuristic style.

People are walking all over the place with books in their hands, phones in their ears or holding their bags while sprinting somewhere as if they're late. I doubt any of them would talk.

On the far end of the room there's a big reception area, with three spots for receptionists to welcome in visitors and guide them to where they need to go though, at this time, there's only one present, and she looks free to talk to, maybe i could talk to her.

There's something strange to the East, i can see a small door almost completly covered by a group of plants leaning over to it, like they we're placed there to hide it.

You can see a receptionist here.

>go n
Justice Avenue
Back in the Justice Avenue. Looks like the Park is finally open. Maybe I should go inside and look at the ducks.

You can see a closed park gate that leads to the Daniel Louis-Campbell Park. and Mike here.

>go e
Daniel Louis-Campbell Park
I used to come here as a kid, there was a playground further in where mom and dad used to play catch with me.

Looks like there is a lake here. So pretty.

You can see a closed park gate that leads to the Daniel Louis-Campbell Park. and a lake here.

>go w
Justice Avenue
Back in the Justice Avenue. Looks like the Park is finally open. Maybe I should go inside and look at the ducks.

You can see a closed park gate that leads to the Daniel Louis-Campbell Park. and Mike here.

>talk to mike
"I can finally see the ducks! I'm so excited to finally enter the DLC Park!"

>go e
Daniel Louis-Campbell Park
I used to come here as a kid, there was a playground further in where mom and dad used to play catch with me.

Looks like there is a lake here. So pretty.

You can see a closed park gate that leads to the Daniel Louis-Campbell Park. and a lake here.

>1
That's not a verb I recognise.

>inventory
You are carrying:
  an Old Key
  a tiara

>throw old key at the lake
Oh. It sunk immediatly. Oops.

>inventory
You are carrying:
  a tiara

* * *

You wake up from a quick nap in your office. You look around - you clearly haven't cleaned it in a while. How could you, with the biggest case you've ever faced still unsolved?

Detective Afonzo and The Cult of La Mancha
An Interactive Fiction by Alien Cat Studios
Release 1 / Serial number 260530 / Inform 7 v10.1.2 / D

Office
 My dusty old office, I've solved so many crimes here... but none like the mystery im facing now.

You can see a desk, a closet (closed) and a rack (on which are a green hat, a red hat, a black hat, a tiara and a trophy) here.

>examine desk
My desk is a mess... I really need to clean this up...

>clean desk
There we go, I got rid of all the junk now!

>examine desk
My desk is spotless now!

On the desk are a doctor's note, an old newspaper and a tablet.

>examine doctor's note
A note from an appointment that reads: "severe case of amnesia, causing a memory loss of the past 2 weeks.". It's all a fog to me.

>examine old newspaper
My parents were pretty important in stopping the corruption in this city... I'm sure a lot of people would want them dead. It's not surprising this is in the cover of the newspaper... but I will find out who did this!

>read doctor's note
There are more comments here... why did they perform an x-ray on me? I can't understand it.

>examine rack
All of my hats are here, and my trophy as well.

On the rack are a green hat, a red hat, a black hat, a tiara and a trophy.

>wear tiara
(first taking the tiara)
Nobody can question my fashion! I will walk out with a tiara if I want!

>wear red hat
(first taking the red hat)
High fashion for Alfonzo Sapienze! This looks good on me.

>inventory
You are carrying:
  a red hat
  a tiara

>leave the office
I only understood you as far as wanting to leave.

>leave
The 68th Street
The 68th Street is busy, noisy, and covered in advertisements. Just another normal day in the city.

* * *

>examine doctor's note
A note from an appointment that reads: "severe case of amnesia, causing a memory loss of the past 2 weeks.". It's all a fog to me.

>go outside
The 68th Street

>go w
You can't go that way.

>go e
St Miku Crossing

>go w
The 68th Street

>look around
You can't see any such thing.

>enter office
You can't see any such thing.

>go office
You can't see any such thing.

>go to office
You can't see any such thing.

* * *

You wake up from a quick nap in your office. You look around - you clearly haven't cleaned it in a while. How could you, with the biggest case you've ever faced still unsolved?

Detective Afonzo and The Cult of La Mancha
An Interactive Fiction by Alien Cat Studios
Release 1 / Serial number 260530 / Inform 7 v10.1.2 / D

Office
 My dusty old office, I've solved so many crimes here... but none like the mystery im facing now.

You can see a desk, a closet (closed) and a rack (on which are a green hat, a red hat, a black hat, a tiara and a trophy) here.

>examine office
You can't see any such thing.

* * *

You wake up from a quick nap in your office. You look around - you clearly haven't cleaned it in a while. How could you, with the biggest case you've ever faced still unsolved?

Detective Afonzo and The Cult of La Mancha
An Interactive Fiction by Alien Cat Studios
Release 1 / Serial number 260530 / Inform 7 v10.1.2 / D

Office
 My dusty old office, I've solved so many crimes here... but none like the mystery im facing now.

You can see a desk, a closet (closed) and a rack (on which are a green hat, a red hat, a black hat, a tiara and a trophy) here.

>examine the desk
My desk is a mess... I really need to clean this up...

>clean the desk
There we go, I got rid of all the junk now!

>clean the desk
There we go, I got rid of all the junk now!

>examine the desk
My desk is spotless now!

On the desk are a doctor's note, an old newspaper and a tablet.

* * *

You wake up from a quick nap in your office. You look around - you clearly haven't cleaned it in a while. How could you, with the biggest case you've ever faced still unsolved?

Detective Afonzo and The Cult of La Mancha
An Interactive Fiction by Alien Cat Studios
Release 1 / Serial number 260530 / Inform 7 v10.1.2 / D

Office
 My dusty old office, I've solved so many crimes here... but none like the mystery im facing now.

You can see a desk, a closet (closed) and a rack (on which are a green hat, a red hat, a black hat, a tiara and a trophy) here.

>investigate desk
I am investigating this case. I don't investigate objects or people. I examine them. Let us not stain the true work of a detective.

>investigate desk
I already said this. I examine things, I don't investigate. Do not test my patience, player.

>investigate desk
You are very persistent and annoying. Stop trying to investigate things. The command is to examine things. Stop insisting.

>investigate desk
Ok you know what. Fine. You win. I will investigate this. You don't need to examine anything ever again. But just because of that, I'm throwing everything in the inventory away so you can never see it again, you smarty-pants. Fool.

My desk is a mess... I really need to clean this up...

>investigate desk
My desk is a mess... I really need to clean this up...

* * *

You wake up from a quick nap in your office. You look around - you clearly haven't cleaned it in a while. How could you, with the biggest case you've ever faced still unsolved?

Detective Afonzo and The Cult of La Mancha
An Interactive Fiction by Alien Cat Studios
Release 1 / Serial number 260530 / Inform 7 v10.1.2 / D

Office
 My dusty old office, I've solved so many crimes here... but none like the mystery im facing now.

You can see a desk, a closet (closed) and a rack (on which are a green hat, a red hat, a black hat, a tiara and a trophy) here.

>leave
I could leave, but to where? I should probably read my cases first.
My cases should be inside the closet... it's probably a mess in there.

>examine desk
My desk is a mess... I really need to clean this up...

* * *

>examine doctor's note
A note from an appointment that reads: "severe case of amnesia, causing a memory loss of the past 2 weeks.". It's all a fog to me.

>read doctor's note
There are more comments here... why did they perform an x-ray on me? I can't understand it.

>examine old newspaper
A newspaper from 2 weeks ago with a disturbing front page... "Corruption may win - João and Maria Alfonzo found dead in a dark alley". How can't I remember that day?

>read old newspaper
My parents were pretty important in stopping the corruption in this city... I'm sure a lot of people would want them dead. It's not surprising this is in the cover of the newspaper... but I will find out who did this!

>read tablet
What is wrong with me... I can't read this!

>examine tablet
A tablet where I keep my diary... but for some reason the past 2 weeks have been erased... precisely the time I lost my memory...

>examine closet
You see nothing special about the closet.

>open closet
What a mess... well, look what we have here... this pile of paper has my current cases, and it's piling up... I should take a look at these.

>examine pile of paper
There are 2 cases here. Another couple just like my parents, found in Bingo Street... and a judge killed in his own chambers. He was working on some case about a cosmetics company.

>read pile of paper
The first case happened a week ago... they were found dead in a trash can. According to the police report, they had very peculiar injuries... it looks like they fought with the attacker.
As for the second case, it was just delivered to me. The body is still in the courthouse, so I should head there soon. Judge Richard was found dead in his chambers found with a knife in his head. A judge can get a lot of enemies, but he was only working on one case at the time... I should go there.

>leave
It's chilly outside. I should probably wear a hat.

>examine rack
All of my hats are here, and my trophy as well.

On the rack are a green hat, a red hat, a black hat, a tiara and a trophy.

>wear trophy
(first taking the trophy)
You can't wear that!

>wear tiara
(first taking the tiara)
Nobody can question my fashion! I will walk out with a tiara if I want!

>leave
The 68th Street
The 68th Street is busy, noisy, and covered in advertisements. Just another normal day in the city.

>look
The 68th Street
The 68th Street is busy, noisy, and covered in advertisements. Just another normal day in the city.

>map
That's not a verb I recognise.

>go w
You can't go that way.

>go e
St Miku Crossing
A colorful crossing surrounded by shops, screens, and people moving in every direction.

>go s
Justice Avenue
Justice Avenue is wider, cleaner, and quieter than most streets in the city. There are fewer advertisements here, as if even the corporations are afraid to be too loud near the court.

People in expensive suits walk past you with briefcases, phones, and serious expressions. The street clearly belongs to the rich, but not completely. A few homeless people sit near the walls and corners, ignored by almost everyone who passes.

To the east, you can see the entrance to Daniel Louis-Campbell Park, but the gate is closed. To the south stands the entrance to El Court Americano. To the west, the street continues toward Bingo Street.

You can see a closed park gate and Miguel here.

>go s
El Court" Americano - Entrance
The courtroom entrance is enormous and strangely beautiful, mixing classical architecture with cold futurism. White marble covers the floor and walls, while brutalist concrete pillars rise sharply toward the ceiling. Huge LED panels glow above the room, bathing the semi-classical statues and minimalist furniture in artificial light.

Crowds of people move from one side to the other, almost all carrying books, documents, or tablets. Some speak quickly into phones, others argue in low voices, and a few hurry past without even looking at you. It is impossible to find even a second of silence here.

Behind a polished counter stands a receptionist, apparently the only person in the room who might actually answer a question.

You can see a receptionist here.

>go to El Court' Americano
You can't see any such thing.

>enter El Court' Americano
You can't see any such thing.

>go s
You can't go that way.

>enter El Court Americano
You can't see any such thing.

>leave
Justice Avenue
Justice Avenue is wider, cleaner, and quieter than most streets in the city. There are fewer advertisements here, as if even the corporations are afraid to be too loud near the court.

People in expensive suits walk past you with briefcases, phones, and serious expressions. The street clearly belongs to the rich, but not completely. A few homeless people sit near the walls and corners, ignored by almost everyone who passes.

To the east, you can see the entrance to Daniel Louis-Campbell Park, but the gate is closed. To the south stands the entrance to El Court Americano. To the west, the street continues toward Bingo Street.

You can see a closed park gate and Miguel here.

>enter El Court Americano
You can't see any such thing.

>go to El Court Americano
You can't see any such thing.

>go s
El Court" Americano - Entrance
The courtroom entrance is enormous and strangely beautiful, mixing classical architecture with cold futurism. White marble covers the floor and walls, while brutalist concrete pillars rise sharply toward the ceiling. Huge LED panels glow above the room, bathing the semi-classical statues and minimalist furniture in artificial light.

Crowds of people move from one side to the other, almost all carrying books, documents, or tablets. Some speak quickly into phones, others argue in low voices, and a few hurry past without even looking at you. It is impossible to find even a second of silence here.

Behind a polished counter stands a receptionist, apparently the only person in the room who might actually answer a question.

You can see a receptionist here.

>examine lady
This lady seems competent. And she is typing so fast too. And cute too. Maybe I can ask her out on a date after I solve this case.

>talk to lady
Hello, may I know where Judge Richard's chambers are?
"I'm sorry, but he is quite busy at the moment, you need to return another day."
I am Detective Alfonzo. I was called here to investigate his death.
"My apologies... it's that room to the right."

>talk to lady
"The Judge was a good man. He was always fair in his trials. Why would someone kill him?..."

>examine statue
They sure have the budget... but why is the lady blind? Weird stuff.

>go to Judge Richard's Chamber
You can't see any such thing.

>go s
You can't go that way.

>go inside
> A strange man bumps into you.
Hey! Watch where you're going!
He's already gone... could have at least apologized.

Judge Richards's Chamber
I think I remember this guy... didn't I use to come here with my mother when I was a child? Maybe she was on one of his trials in the past...

* * *

>leave
I could leave, but to where? I should probably read my cases first.
My cases should be inside the closet... it's probably a mess in there.

>open close
You can't see any such thing.

>open closet
What a mess... well, look what we have here... this pile of paper has my current cases, and it's piling up... I should take a look at these.

>leave
I could leave, but to where? I should probably read my cases first.

>read cases
There are 2 cases here. Another couple just like my parents, found in Bingo Street... and a judge killed in his own chambers. He was working on some case about a cosmetics company. Before I leave though I should probably read these with more detail.

The first case happened a week ago... they were found dead in a trash can. According to the police report, they had very peculiar injuries... it looks like they fought with the attacker.
As for the second case, it was just delivered to me. The body is still in the courthouse, so I should head there soon. Judge Richard was found dead in his chambers found with a knife in his head. A judge can get a lot of enemies, but he was only working on one case at the time... I should go there.

>read cases
The first case happened a week ago... they were found dead in a trash can. According to the police report, they had very peculiar injuries... it looks like they fought with the attacker.
As for the second case, it was just delivered to me. The body is still in the courthouse, so I should head there soon. Judge Richard was found dead in his chambers found with a knife in his head. A judge can get a lot of enemies, but he was only working on one case at the time... I should go there.

* * *

You wake up from a quick nap in your office. You look around - you clearly haven't cleaned it in a while. How could you, with the biggest case you've ever faced still unsolved?

Detective Afonzo and The Cult of La Mancha
An Interactive Fiction by Alien Cat Studios
Release 1 / Serial number 260530 / Inform 7 v10.1.2 / D

Office
 My dusty old office, I've solved so many crimes here... but none like the mystery im facing now.

You can see a desk, a closet (closed) and a rack (on which are a green hat, a red hat, a black hat, a tiara and a trophy) here.

>script on
Start of a transcript of:

Detective Afonzo and The Cult of La Mancha
An Interactive Fiction by Alien Cat Studios
Release 1 / Serial number 260525 / Inform 7 v10.1.2 / D
Inform 7 v10.1.2
Identification number: //3F4AAB80-A3D7-4E51-8CD6-97F45F8917F6//
Interpreter version 0.6.1 / VM 3.1.3
Hiding Under version 4 by Eric Eve

>open closet
What a mess... well, look what we have here... this pile of paper has my current cases, and it's piling up... I should take a look at these.

>examine paper
There are 2 cases here. Another couple just like my parents, found in Bingo Street... and a judge killed in his own chambers. He was working on some case about a cosmetics company.

>go Bingo Street
You can't see any such thing.

>go n
I could leave, but to where? I should probably read my cases first.

>read cases
You can't see any such thing.

>read paper
The first case happened a week ago... they were found dead in a trash can. According to the police report, they had very peculiar injuries... it looks like they fought with the attacker.
As for the second case, it was just delivered to me. The body is still in the courthouse, so I should head there soon. Judge Richard was found dead in his chambers found with a knife in his head. A judge can get a lot of enemies, but he was only working on one case at the time... I should go there.

>go chambers
You can't see any such thing.

>leave
It's chilly outside. I should probably wear a hat.

>back
That's not a verb I recognise.

>pick hat
I didn't understand that sentence.

>grab hat
That's not a verb I recognise.

>go rack
That's not something you can enter.

>open rack
It isn't something you can open.

>grab rack
That's not a verb I recognise.

>examine rack
All of my hats are here, and my trophy as well.

On the rack are a green hat, a red hat, a black hat, a tiara and a trophy.

>examine green hat
This hat is perfect for St. Patrick celebrations.

>use green hat
That's not a verb I recognise.

>pick up green hat
Taken.

>leave
It's chilly outside. I should probably wear a hat.

>where
That's not a verb I recognise.

>weare
That's not a verb I recognise.

>wear
(the green hat)
High fashion for Alfonzo Sapienze! This looks good on me.

>leave
The 68th Street
68th Street looks as busy, noisy and smelly as usual. Cars are flying around, ads cover every screen, and people walk and move around in their trendy clothes like ants going to and from their home colonies, living their happy lives mindlessly.

Both murders happened in another part of the town, I think have to go east.

>e
St Miku Crossing
St. Miku Crossing, the epitome of modern city living, a sea of people surrounded by cars, shops and buildings as tall as the eye can see, piercing the clouds above like a knife.

I see the Justice Avenue to the South, as well as the 68th Street to the West.

>w
The 68th Street
68th Street looks as busy, noisy and smelly as usual. Cars are flying around, ads cover every screen, and people walk and move around in their trendy clothes like ants going to and from their home colonies, living their happy lives mindlessly.

Both murders happened in another part of the town, I think have to go east.

>e
St Miku Crossing
St. Miku Crossing, the epitome of modern city living, a sea of people surrounded by cars, shops and buildings as tall as the eye can see, piercing the clouds above like a knife.

I see the Justice Avenue to the South, as well as the 68th Street to the West.

>e
You can't go that way.

>w
The 68th Street
68th Street looks as busy, noisy and smelly as usual. Cars are flying around, ads cover every screen, and people walk and move around in their trendy clothes like ants going to and from their home colonies, living their happy lives mindlessly.

Both murders happened in another part of the town, I think have to go east.

* * *

>e
St Miku Crossing
St. Miku Crossing, the epitome of modern city living, a sea of people surrounded by cars, shops and buildings as tall as the eye can see, piercing the clouds above like a knife.

I see the Justice Avenue to the South, as well as the 68th Street to the West.

>n
You can't go that way.

>s
Justice Avenue
Justice Avenue looks as tidy as ever, it's the home of the city's rich and powerful, where the oligarchs and polititians come together to scheme whatever greedy plans they have... and they call it Justice, heh.

The ads here are different, instead of the newest movies and products, it's fine dining and jewelry. Even the people look different, the neon bright colors are now replaced by more sublte, darker tones, the hoodies turn to suits and ties and the smiles to stone cold expressions.

They don't even notice me walk by.

There's multiple ways to go from here, east, to the Daniel Louis-Campbell Park, to the south where the El Court" Americano is and to the west, towards Bingo Street.

You can see a closed park gate that leads to the Daniel Louis-Campbell Park. and Mike here.

>talk to Mike
"I wanted to see the small ducks, but they are under construction..."
...
"I mean the park, not the ducks!
Oh. Ok... I'm just gonna go now...
"Oh ok Mr. High-And-Mighty-Normal-Hat-Wearer. Could at least wear something cool like a tiara!"

>w
Bingo Street
Bingo Street is like a louder, more run down version of 68th Street, if that's even possible. The atmosphere feels similar, but the people don't, they feel more like the ones on Justice Avenue, only without all the money.

The cops don't usually come here, they're paid well not to... damn bastards.

For some reason they decided to build a damn company here, i'd go in but the place is in repairs from what it looks like, about time if ya ask me, thought it'd be better if the people got that treatment first, it's been needed for a long ass time.

>n
You can't go that way.

>e
Justice Avenue
Justice Avenue looks as tidy as ever, it's the home of the city's rich and powerful, where the oligarchs and polititians come together to scheme whatever greedy plans they have... and they call it Justice, heh.

The ads here are different, instead of the newest movies and products, it's fine dining and jewelry. Even the people look different, the neon bright colors are now replaced by more sublte, darker tones, the hoodies turn to suits and ties and the smiles to stone cold expressions.

They don't even notice me walk by.

There's multiple ways to go from here, east, to the Daniel Louis-Campbell Park, to the south where the El Court" Americano is and to the west, towards Bingo Street.

You can see a closed park gate that leads to the Daniel Louis-Campbell Park. and Mike here.

>open park gate
It's still under construction...

>go n
St Miku Crossing
St. Miku Crossing, the epitome of modern city living, a sea of people surrounded by cars, shops and buildings as tall as the eye can see, piercing the clouds above like a knife.

I see the Justice Avenue to the South, as well as the 68th Street to the West.

I beg your pardon?

>w
The 68th Street
68th Street looks as busy, noisy and smelly as usual. Cars are flying around, ads cover every screen, and people walk and move around in their trendy clothes like ants going to and from their home colonies, living their happy lives mindlessly.

Both murders happened in another part of the town, I think have to go east.

>w
You can't go that way.

>n
You can't go that way.

>s
You can't go that way.

>e
St Miku Crossing
St. Miku Crossing, the epitome of modern city living, a sea of people surrounded by cars, shops and buildings as tall as the eye can see, piercing the clouds above like a knife.

I see the Justice Avenue to the South, as well as the 68th Street to the West.

>s
Justice Avenue
Justice Avenue looks as tidy as ever, it's the home of the city's rich and powerful, where the oligarchs and polititians come together to scheme whatever greedy plans they have... and they call it Justice, heh.

The ads here are different, instead of the newest movies and products, it's fine dining and jewelry. Even the people look different, the neon bright colors are now replaced by more sublte, darker tones, the hoodies turn to suits and ties and the smiles to stone cold expressions.

They don't even notice me walk by.

There's multiple ways to go from here, east, to the Daniel Louis-Campbell Park, to the south where the El Court" Americano is and to the west, towards Bingo Street.

You can see a closed park gate that leads to the Daniel Louis-Campbell Park. and Mike here.

>w
Bingo Street
Bingo Street is like a louder, more run down version of 68th Street, if that's even possible. The atmosphere feels similar, but the people don't, they feel more like the ones on Justice Avenue, only without all the money.

The cops don't usually come here, they're paid well not to... damn bastards.

For some reason they decided to build a damn company here, i'd go in but the place is in repairs from what it looks like, about time if ya ask me, thought it'd be better if the people got that treatment first, it's been needed for a long ass time.

>e
Justice Avenue
Justice Avenue looks as tidy as ever, it's the home of the city's rich and powerful, where the oligarchs and polititians come together to scheme whatever greedy plans they have... and they call it Justice, heh.

The ads here are different, instead of the newest movies and products, it's fine dining and jewelry. Even the people look different, the neon bright colors are now replaced by more sublte, darker tones, the hoodies turn to suits and ties and the smiles to stone cold expressions.

They don't even notice me walk by.

There's multiple ways to go from here, east, to the Daniel Louis-Campbell Park, to the south where the El Court" Americano is and to the west, towards Bingo Street.

You can see a closed park gate that leads to the Daniel Louis-Campbell Park. and Mike here.

>s
El Court" Americano - Main Hall
I've always loved the look of this place, it's like a beacon of life in the middle of a sea of gray concrete mediocrity. It's a massive square entrance with big glass doors that let the sunshine come in during the day.

The architecture of it somehow strikes a perfect balance between between classic, roman-inspired designs and a smooth, minimalism-heavy futuristic style.

People are walking all over the place with books in their hands, phones in their ears or holding their bags while sprinting somewhere as if they're late. I doubt any of them would talk.

On the far end of the room there's a big reception area, with three spots for receptionists to welcome in visitors and guide them to where they need to go though, at this time, there's only one present, and she looks free to talk to, maybe i could talk to her.

There's something strange to the East, i can see a small door almost completly covered by a group of plants leaning over to it, like they we're placed there to hide it.

You can see a receptionist here.

>examine receptionist
This lady seems competent. And she is typing so fast too. And cute too. Maybe I can ask her out on a date after I solve this case.

>talk to lady
Hello, may I know where Judge Richard's chambers are?
"I'm sorry, but he is quite busy at the moment, you need to return another day."
I am Detective Alfonzo. I was called here to investigate his death.
"My apologies... it's that room to the right."
I thought my hat would give it away...

>go right
You can't see any such thing.

>e
Suspicious Alley
The door lead to a narrow, stinking alleyway, isolated from the rest of the city.

There's rats all over and spiders crawling on the walls. There is no way to go but forwards, to the darkness.

>undo
El Court" Americano - Main Hall
[Previous turn undone.]

>go inside
>A strange man bumps into you.
Hey! Watch where you're going!
He's already gone... could have at least apologized.

El Court" Americano - Judge Richard's Office
I remember hearing about this guy from my mother... I think they worked together a couple of times...

This is one small office... looks old, older than the rest of the building, like it's holding on to a long forgotten past.

It's well kept though, despite... everything.

You can see a Fancy Desk (on which is an Open Letter), a Judge Richard's Dead Body, a Blood Stain and a Bookshelf here.

>examine fancy desk
This desk has some fine craftsmanship, suiting for a judge. Though it's starting to show it's age.

I should take a closer look at it.

On the Fancy Desk is an Open Letter.

>look fancy desk
This desk has some fine craftsmanship, suiting for a judge. Though it's starting to show it's age.

I should take a closer look at it.

On the Fancy Desk is an Open Letter.

>open letter
It isn't something you can open.

>look closely
You can't see any such thing.

>examine open letter
Hold on, this letter is in my mother's handwritting... looks like they were close, much closer than i thought.

They were working on a case together for her activism, but I can't make out the rest of it though.

>n
You can't go that way.

>e
You can't go that way.

>w
You can't go that way.

>s
You can't go that way.

>examine
(the green hat)
This hat is perfect for St. Patrick celebrations.

>examine Judge Richard's Dead Body
Poor old bastard. Stabbed in the back of the head, whoever did this wanted to make sure he didn't walk out of here alive.

The knife is missing.

>search knife
You can't see any such thing.

>examine Blood Stain
There's a trail of blood leading underneath the bookshelf.

>examine bookshelf
An old bookshelf, filled to the brim with all kinds of books and memorabilia

>go under bookshelf
You can't see any such thing.

>under
That's not a verb I recognise.

>examine underneath
You can't see any such thing.

>bookshelf
That's not a verb I recognise.

>look under bookshelf
Under the Bookshelf you find a Bloody Knife.

>pick up Bloody Knife
Taken.

>examine bloody knife
Must be the murder weapon. The blood's gone dry.

There's a symbol of a hand on the handle. The blade looks odd... now that i look at it, this kind of thing could do some real damage if handled improperly, the same kind of damage found on that couple in Bingo Street.

This thing was hiding under the bookshelf... I wonder if there are other hidden things i could find.

>look under bookshelf
You find nothing of interest.

>findo other things
That's not a verb I recognise.

>look under desk
Under the Fancy Desk you find an old key.

>examine old key
This key is familiar... where have I seen it before?

>pick up old key
A key? I wonder what I could do with this...

Taken.

>use old key
That's not a verb I recognise.

>use bloody knife
That's not a verb I recognise.

>drop bloody knife
Dropped.

>pick up bloody knife
Taken.

>exit
El Court" Americano - Main Hall
I've always loved the look of this place, it's like a beacon of life in the middle of a sea of gray concrete mediocrity. It's a massive square entrance with big glass doors that let the sunshine come in during the day.

The architecture of it somehow strikes a perfect balance between between classic, roman-inspired designs and a smooth, minimalism-heavy futuristic style.

People are walking all over the place with books in their hands, phones in their ears or holding their bags while sprinting somewhere as if they're late. I doubt any of them would talk.

On the far end of the room there's a big reception area, with three spots for receptionists to welcome in visitors and guide them to where they need to go though, at this time, there's only one present, and she looks free to talk to, maybe i could talk to her.

There's something strange to the East, i can see a small door almost completly covered by a group of plants leaning over to it, like they we're placed there to hide it.

You can see a receptionist here.

>invite lady to date
That's not a verb I recognise.

>exit
Justice Avenue
Back in the Justice Avenue. Looks like the Park is finally open. Maybe I should go inside and look at the ducks.

You can see a closed park gate that leads to the Daniel Louis-Campbell Park. and Mike here.

>exit
But you aren't in anything at the moment.

>quit
Are you sure you want to quit?

* * *

>scipt off
That's not a verb I recognise.

>script off
End of transcript.

>quit game
I only understood you as far as wanting to quit.

>quit
Are you sure you want to quit?

* * *

>script on
Start of a transcript of:

Detective Afonzo and The Cult of La Mancha
An Interactive Fiction by Alien Cat Studios
Release 1 / Serial number 260525 / Inform 7 v10.1.2 / D
Inform 7 v10.1.2
Identification number: //3F4AAB80-A3D7-4E51-8CD6-97F45F8917F6//
Interpreter version 0.6.1 / VM 3.1.3
Hiding Under version 4 by Eric Eve

>pick black hat
I didn't understand that sentence.

>pick up black hat
Taken.

>eat black hat
That's plainly inedible.

>open closet
What a mess... well, look what we have here... this pile of paper has my current cases, and it's piling up... I should take a look at these.

>burn paper
This dangerous act would achieve little.

>put black hat on
High fashion for Alfonzo Sapienze! This looks good on me.

>examine black hat
I look like Professor Layton now!

>take black hat out
I only understood you as far as wanting to take the black hat.

>take black hat up~
I only understood you as far as wanting to take the black hat.

>take black hat up
I only understood you as far as wanting to take the black hat.

>remove black hat
You aren't wearing the black hat.

>wear hat
(the black hat)
High fashion for Alfonzo Sapienze! This looks good on me.

>remove black hat
You aren't wearing the black hat.

>pick papers
I didn't understand that sentence.

>pick paper
I didn't understand that sentence.

>take paper
Taken.

>inv
You are carrying:
  a pile of paper
  a black hat

>examine paper
There are 2 cases here. Another couple just like my parents, found in Bingo Street... and a judge killed in his own chambers. He was working on some case about a cosmetics company.

>leave
I could leave, but to where? I should probably read my cases first.

>read case
You can't see any such thing.

>read cases
You can't see any such thing.

* * *

>read paper
The first case happened a week ago... they were found dead in a trash can. According to the police report, they had very peculiar injuries... it looks like they fought with the attacker.
As for the second case, it was just delivered to me. The body is still in the courthouse, so I should head there soon. Judge Richard was found dead in his chambers found with a knife in his head. A judge can get a lot of enemies, but he was only working on one case at the time... I should go there.

>examine paper
There are 2 cases here. Another couple just like my parents, found in Bingo Street... and a judge killed in his own chambers. He was working on some case about a cosmetics company.

>look paper
There are 2 cases here. Another couple just like my parents, found in Bingo Street... and a judge killed in his own chambers. He was working on some case about a cosmetics company.

>investigate paper
That's not a verb I recognise.

>leave
The 68th Street
68th Street looks as busy, noisy and smelly as usual. Cars are flying around, ads cover every screen, and people walk and move around in their trendy clothes like ants going to and from their home colonies, living their happy lives mindlessly.

Both murders happened in another part of the town, I think have to go east.

>east
St Miku Crossing
St. Miku Crossing, the epitome of modern city living, a sea of people surrounded by cars, shops and buildings as tall as the eye can see, piercing the clouds above like a knife.

I see the Justice Avenue to the South, as well as the 68th Street to the West.

>enter justice avenue~
You can't see any such thing.

>enter justice avenue
You can't see any such thing.

>go south
Justice Avenue
Justice Avenue looks as tidy as ever, it's the home of the city's rich and powerful, where the oligarchs and polititians come together to scheme whatever greedy plans they have... and they call it Justice, heh.

The ads here are different, instead of the newest movies and products, it's fine dining and jewelry. Even the people look different, the neon bright colors are now replaced by more sublte, darker tones, the hoodies turn to suits and ties and the smiles to stone cold expressions.

They don't even notice me walk by.

There's multiple ways to go from here, east, to the Daniel Louis-Campbell Park, to the south where the El Court" Americano is and to the west, towards Bingo Street.

You can see a closed park gate that leads to the Daniel Louis-Campbell Park. and Mike here.

>open gate
It's still under construction...

>destroy gate
Violence isn't the answer to this one.

>kick gate
That's not a verb I recognise.

>read ads
You can't see any such thing.

>examine ads
You can't see any such thing.

>talk person~
I didn't understand that sentence.

>talk~
That's not a verb I recognise.

>talk
(to Mike)
"I wanted to see the small ducks, but they are under construction..."
...
"I mean the park, not the ducks!
Oh. Ok... I'm just gonna go now...
"Oh ok Mr. High-And-Mighty-Normal-Hat-Wearer. Could at least wear something cool like a tiara!"

>shut up
You must name something more substantial.

>shut up mike
He isn't something you can close.

>punch mike
Violence isn't the answer to this one.

>talk mike
I didn't understand that sentence.

>leave
But you aren't in anything at the moment.

>go n
St Miku Crossing
St. Miku Crossing, the epitome of modern city living, a sea of people surrounded by cars, shops and buildings as tall as the eye can see, piercing the clouds above like a knife.

I see the Justice Avenue to the South, as well as the 68th Street to the West.

>go w
The 68th Street
68th Street looks as busy, noisy and smelly as usual. Cars are flying around, ads cover every screen, and people walk and move around in their trendy clothes like ants going to and from their home colonies, living their happy lives mindlessly.

Both murders happened in another part of the town, I think have to go east.

>go e
St Miku Crossing
St. Miku Crossing, the epitome of modern city living, a sea of people surrounded by cars, shops and buildings as tall as the eye can see, piercing the clouds above like a knife.

I see the Justice Avenue to the South, as well as the 68th Street to the West.

>go home
You can't see any such thing.

>go e
You can't go that way.

>go w
The 68th Street
68th Street looks as busy, noisy and smelly as usual. Cars are flying around, ads cover every screen, and people walk and move around in their trendy clothes like ants going to and from their home colonies, living their happy lives mindlessly.

Both murders happened in another part of the town, I think have to go east.

>examine car
You can't see any such thing.

>go e
St Miku Crossing
St. Miku Crossing, the epitome of modern city living, a sea of people surrounded by cars, shops and buildings as tall as the eye can see, piercing the clouds above like a knife.

I see the Justice Avenue to the South, as well as the 68th Street to the West.

>go e
You can't go that way.

>go n
You can't go that way.

>go s
Justice Avenue
Justice Avenue looks as tidy as ever, it's the home of the city's rich and powerful, where the oligarchs and polititians come together to scheme whatever greedy plans they have... and they call it Justice, heh.

The ads here are different, instead of the newest movies and products, it's fine dining and jewelry. Even the people look different, the neon bright colors are now replaced by more sublte, darker tones, the hoodies turn to suits and ties and the smiles to stone cold expressions.

They don't even notice me walk by.

There's multiple ways to go from here, east, to the Daniel Louis-Campbell Park, to the south where the El Court" Americano is and to the west, towards Bingo Street.

You can see a closed park gate that leads to the Daniel Louis-Campbell Park. and Mike here.

>enter
You must supply a noun.

>go s
El Court" Americano - Main Hall
I've always loved the look of this place, it's like a beacon of life in the middle of a sea of gray concrete mediocrity. It's a massive square entrance with big glass doors that let the sunshine come in during the day.

The architecture of it somehow strikes a perfect balance between between classic, roman-inspired designs and a smooth, minimalism-heavy futuristic style.

People are walking all over the place with books in their hands, phones in their ears or holding their bags while sprinting somewhere as if they're late. I doubt any of them would talk.

On the far end of the room there's a big reception area, with three spots for receptionists to welcome in visitors and guide them to where they need to go though, at this time, there's only one present, and she looks free to talk to, maybe i could talk to her.

There's something strange to the East, i can see a small door almost completly covered by a group of plants leaning over to it, like they we're placed there to hide it.

You can see a receptionist here.

>inv
You are carrying:
  a pile of paper
  a black hat

>talk
(to the receptionist)
Hello, may I know where Judge Richard's chambers are?
"I'm sorry, but he is quite busy at the moment, you need to return another day."
I am Detective Alfonzo. I was called here to investigate his death.
"My apologies... it's that room to the right."
I thought my hat would give it away...

>go r
You can't see any such thing.

>go right
You can't see any such thing.

>go e
Suspicious Alley
The door lead to a narrow, stinking alleyway, isolated from the rest of the city.

There's rats all over and spiders crawling on the walls. There is no way to go but forwards, to the darkness.

>go w
El Court" Americano - Main Hall
I've always loved the look of this place, it's like a beacon of life in the middle of a sea of gray concrete mediocrity. It's a massive square entrance with big glass doors that let the sunshine come in during the day.

The architecture of it somehow strikes a perfect balance between between classic, roman-inspired designs and a smooth, minimalism-heavy futuristic style.

People are walking all over the place with books in their hands, phones in their ears or holding their bags while sprinting somewhere as if they're late. I doubt any of them would talk.

On the far end of the room there's a big reception area, with three spots for receptionists to welcome in visitors and guide them to where they need to go though, at this time, there's only one present, and she looks free to talk to, maybe i could talk to her.

There's something strange to the East, i can see a small door almost completly covered by a group of plants leaning over to it, like they we're placed there to hide it.

You can see a receptionist here.

>go e
Suspicious Alley
The door lead to a narrow, stinking alleyway, isolated from the rest of the city.

There's rats all over and spiders crawling on the walls. There is no way to go but forwards, to the darkness.

>take raat
You can't see any such thing.

>take rat
You can't see any such thing.

>look rat
You can't see any such thing.

>look spider
You can't see any such thing.

>go forward
You can't see any such thing.

>go inside
Tiara Palace
Of all the places i expected to find here, a damn palace is the last one. It doesn't really look like a palace, it's more like a rainbow, glittery nightclub stuck at the end of a long, narrow alleyway.

It has a small little entrance sitting at the bottom of a facade that still manages to be imposing desipite its proportions.

There's a bouncer dressed like a clown waiting at the door, it doesn't look like he's gonna let me in, not while looking like this i'm guessin".

>talk bouncer
I didn't understand that sentence.

>talk
(to yourself)

>leave
Suspicious Alley
The door lead to a narrow, stinking alleyway, isolated from the rest of the city.

There's rats all over and spiders crawling on the walls. There is no way to go but forwards, to the darkness.

>leave
But you aren't in anything at the moment.

>go w~
You can't see any such thing.

>go w
El Court" Americano - Main Hall
I've always loved the look of this place, it's like a beacon of life in the middle of a sea of gray concrete mediocrity. It's a massive square entrance with big glass doors that let the sunshine come in during the day.

The architecture of it somehow strikes a perfect balance between between classic, roman-inspired designs and a smooth, minimalism-heavy futuristic style.

People are walking all over the place with books in their hands, phones in their ears or holding their bags while sprinting somewhere as if they're late. I doubt any of them would talk.

On the far end of the room there's a big reception area, with three spots for receptionists to welcome in visitors and guide them to where they need to go though, at this time, there's only one present, and she looks free to talk to, maybe i could talk to her.

There's something strange to the East, i can see a small door almost completly covered by a group of plants leaning over to it, like they we're placed there to hide it.

You can see a receptionist here.

>go inside
>A strange man bumps into you.
Hey! Watch where you're going!
He's already gone... could have at least apologized.

El Court" Americano - Judge Richard's Office
I remember hearing about this guy from my mother... I think they worked together a couple of times...

This is one small office... looks old, older than the rest of the building, like it's holding on to a long forgotten past.

It's well kept though, despite... everything.

You can see a Fancy Desk (on which is an Open Letter), a Judge Richard's Dead Body, a Blood Stain and a Bookshelf here.

>catch man
That's not a verb I recognise.

>take man
You can't see any such thing.

>grab an
That's not a verb I recognise.

>eat body
That's plainly inedible.

* * *

>open letter
It isn't something you can open.

>examine letter
Hold on, this letter is in my mother's handwritting... looks like they were close, much closer than i thought.

They were working on a case together for her activism, but I can't make out the rest of it though.

>read letter
What is wrong with me... I can't read this!

>examine letter
Hold on, this letter is in my mother's handwritting... looks like they were close, much closer than i thought.

They were working on a case together for her activism, but I can't make out the rest of it though.

>examine dead body
Poor old bastard. Stabbed in the back of the head, whoever did this wanted to make sure he didn't walk out of here alive.

The knife is missing.

>knife?
That's not a verb I recognise.

>look knife
You can't see any such thing.

>take knife
You can't see any such thing.

>examine bookshelf
An old bookshelf, filled to the brim with all kinds of books and memorabilia

>look bookshelf
An old bookshelf, filled to the brim with all kinds of books and memorabilia

>inv
You are carrying:
  a pile of paper
  a black hat

>drop hat
Dropped.

>put paper on bookshelf~
Putting things on the Bookshelf would achieve nothing.

>put paper on bookshelf
Putting things on the Bookshelf would achieve nothing.

>examine body
Poor old bastard. Stabbed in the back of the head, whoever did this wanted to make sure he didn't walk out of here alive.

The knife is missing.

>leave
El Court" Americano - Main Hall
I've always loved the look of this place, it's like a beacon of life in the middle of a sea of gray concrete mediocrity. It's a massive square entrance with big glass doors that let the sunshine come in during the day.

The architecture of it somehow strikes a perfect balance between between classic, roman-inspired designs and a smooth, minimalism-heavy futuristic style.

People are walking all over the place with books in their hands, phones in their ears or holding their bags while sprinting somewhere as if they're late. I doubt any of them would talk.

On the far end of the room there's a big reception area, with three spots for receptionists to welcome in visitors and guide them to where they need to go though, at this time, there's only one present, and she looks free to talk to, maybe i could talk to her.

There's something strange to the East, i can see a small door almost completly covered by a group of plants leaning over to it, like they we're placed there to hide it.

You can see a receptionist here.

>talk
(to the receptionist)
"The Judge was a good man. He was always fair in his trials. Why would someone kill him?..."

>go inside
El Court" Americano - Judge Richard's Office
I remember hearing about this guy from my mother... I think they worked together a couple of times...

This is one small office... looks old, older than the rest of the building, like it's holding on to a long forgotten past.

It's well kept though, despite... everything.

You can see a black hat, a Fancy Desk (on which is an Open Letter), a Judge Richard's Dead Body, a Blood Stain and a Bookshelf here.

>examine fancy desk
This desk has some fine craftsmanship, suiting for a judge. Though it's starting to show it's age.

I should take a closer look at it.

On the Fancy Desk is an Open Letter.

>take letter
Taken.

>open bookshelf
It isn't something you can open.

>examine blood
There's a trail of blood leading underneath the bookshelf.

>move bookshelf
Nothing obvious happens.

>pull book from bookshelf
You can't see any such thing.

>push bookshelf
Nothing obvious happens.

>pull bookshelg
You can't see any such thing.

>look under bookshelf~
Under the Bookshelf you find a Bloody Knife.

>take knife
Taken.

>examine knife
Must be the murder weapon. The blood's gone dry.

There's a symbol of a hand on the handle. The blade looks odd... now that i look at it, this kind of thing could do some real damage if handled improperly, the same kind of damage found on that couple in Bingo Street.

This thing was hiding under the bookshelf... I wonder if there are other hidden things i could find.

>look under bookshelf
You find nothing of interest.

>leave
El Court" Americano - Main Hall
I've always loved the look of this place, it's like a beacon of life in the middle of a sea of gray concrete mediocrity. It's a massive square entrance with big glass doors that let the sunshine come in during the day.

The architecture of it somehow strikes a perfect balance between between classic, roman-inspired designs and a smooth, minimalism-heavy futuristic style.

People are walking all over the place with books in their hands, phones in their ears or holding their bags while sprinting somewhere as if they're late. I doubt any of them would talk.

On the far end of the room there's a big reception area, with three spots for receptionists to welcome in visitors and guide them to where they need to go though, at this time, there's only one present, and she looks free to talk to, maybe i could talk to her.

There's something strange to the East, i can see a small door almost completly covered by a group of plants leaning over to it, like they we're placed there to hide it.

You can see a receptionist here.

>kill receptionist
Violence isn't the answer to this one.

>throw knife at receptionist
You lack the nerve when it comes to the crucial moment.

>throw knife
Dropped.

>east
Suspicious Alley
The door lead to a narrow, stinking alleyway, isolated from the rest of the city.

There's rats all over and spiders crawling on the walls. There is no way to go but forwards, to the darkness.

>go west~
You can't see any such thing.

>go west
El Court" Americano - Main Hall
I've always loved the look of this place, it's like a beacon of life in the middle of a sea of gray concrete mediocrity. It's a massive square entrance with big glass doors that let the sunshine come in during the day.

The architecture of it somehow strikes a perfect balance between between classic, roman-inspired designs and a smooth, minimalism-heavy futuristic style.

People are walking all over the place with books in their hands, phones in their ears or holding their bags while sprinting somewhere as if they're late. I doubt any of them would talk.

On the far end of the room there's a big reception area, with three spots for receptionists to welcome in visitors and guide them to where they need to go though, at this time, there's only one present, and she looks free to talk to, maybe i could talk to her.

There's something strange to the East, i can see a small door almost completly covered by a group of plants leaning over to it, like they we're placed there to hide it.

You can see a Bloody Knife and a receptionist here.

>go inside
El Court" Americano - Judge Richard's Office
I remember hearing about this guy from my mother... I think they worked together a couple of times...

This is one small office... looks old, older than the rest of the building, like it's holding on to a long forgotten past.

It's well kept though, despite... everything.

You can see a black hat, a Fancy Desk, a Judge Richard's Dead Body, a Blood Stain and a Bookshelf here.

>look under desk
Under the Fancy Desk you find an old key.

>grab key
That's not a verb I recognise.

>take key
A key? I wonder what I could do with this...

Taken.

>examine key
This key is familiar... where have I seen it before?

>leave
El Court" Americano - Main Hall
I've always loved the look of this place, it's like a beacon of life in the middle of a sea of gray concrete mediocrity. It's a massive square entrance with big glass doors that let the sunshine come in during the day.

The architecture of it somehow strikes a perfect balance between between classic, roman-inspired designs and a smooth, minimalism-heavy futuristic style.

People are walking all over the place with books in their hands, phones in their ears or holding their bags while sprinting somewhere as if they're late. I doubt any of them would talk.

On the far end of the room there's a big reception area, with three spots for receptionists to welcome in visitors and guide them to where they need to go though, at this time, there's only one present, and she looks free to talk to, maybe i could talk to her.

There's something strange to the East, i can see a small door almost completly covered by a group of plants leaning over to it, like they we're placed there to hide it.

You can see a Bloody Knife and a receptionist here.

>leave
Justice Avenue
Back in the Justice Avenue. Looks like the Park is finally open. Maybe I should go inside and look at the ducks.

You can see a closed park gate that leads to the Daniel Louis-Campbell Park. and Mike here.

>go inside
El Court" Americano - Main Hall
I've always loved the look of this place, it's like a beacon of life in the middle of a sea of gray concrete mediocrity. It's a massive square entrance with big glass doors that let the sunshine come in during the day.

The architecture of it somehow strikes a perfect balance between between classic, roman-inspired designs and a smooth, minimalism-heavy futuristic style.

People are walking all over the place with books in their hands, phones in their ears or holding their bags while sprinting somewhere as if they're late. I doubt any of them would talk.

On the far end of the room there's a big reception area, with three spots for receptionists to welcome in visitors and guide them to where they need to go though, at this time, there's only one present, and she looks free to talk to, maybe i could talk to her.

There's something strange to the East, i can see a small door almost completly covered by a group of plants leaning over to it, like they we're placed there to hide it.

You can see a Bloody Knife and a receptionist here.

>look ducks
You can't see any such thing.

>talk
(to the receptionist)
"The Judge was a good man. He was always fair in his trials. Why would someone kill him?..."

>leave
Justice Avenue
Back in the Justice Avenue. Looks like the Park is finally open. Maybe I should go inside and look at the ducks.

You can see a closed park gate that leads to the Daniel Louis-Campbell Park. and Mike here.

>talk
(to Mike)
"I can finally see the ducks! I'm so excited to finally enter the DLC Park!"

>talk
(to Mike)
"I can finally see the ducks! I'm so excited to finally enter the DLC Park!"

>open park
That's already open.

>go parl
You can't see any such thing.

>go park
Daniel Louis-Campbell Park
I used to come here as a kid, there was a playground further in where mom and dad used to play catch with me.

Looks like there is a lake here. So pretty.

You can see a closed park gate that leads to the Daniel Louis-Campbell Park. and a lake here.

>open park gate
That's already open.

>swim
That's not a verb I recognise.

>go inside
You can't go that way.

>go lake
That's not something you can enter.

>examine lake
Such a pretty lake, and the ducks are sweet too. I remember throwing stones at the lake to see how many times it would rebound. I don't have any stones, but I have a key...

>throw key at lake
Oh. It sunk immediatly. Oops.

>grab key
That's not a verb I recognise.

>throw myself
You lack the dexterity.

>go n
You can't go that way.

>go w
Justice Avenue
Back in the Justice Avenue. Looks like the Park is finally open. Maybe I should go inside and look at the ducks.

You can see a closed park gate that leads to the Daniel Louis-Campbell Park. and Mike here.

>go e
Daniel Louis-Campbell Park
I used to come here as a kid, there was a playground further in where mom and dad used to play catch with me.

Looks like there is a lake here. So pretty.

You can see a closed park gate that leads to the Daniel Louis-Campbell Park. and a lake here.

>go inside
You can't go that way.

>go park
Justice Avenue
Back in the Justice Avenue. Looks like the Park is finally open. Maybe I should go inside and look at the ducks.

You can see a closed park gate that leads to the Daniel Louis-Campbell Park. and Mike here.

>e
Daniel Louis-Campbell Park
I used to come here as a kid, there was a playground further in where mom and dad used to play catch with me.

Looks like there is a lake here. So pretty.

You can see a closed park gate that leads to the Daniel Louis-Campbell Park. and a lake here.

>e
Afonso Sapienze's Parent's Apartment

>kill
What do you want to kill?

>myself
Violence isn't the answer to this one.

>look
Afonso Sapienze's Parent's Apartment

>go n
You can't go that way.

I beg your pardon?

I beg your pardon?

>talk
(to yourself)

>open safe with key
You can't see any such thing.

>unlock safe with key
You can't see any such thing.

>examine locked safe
You can't see any such thing.

>script off
End of transcript.

>quit
Are you sure you want to quit?

>yeds
Please answer yes or no.

* * *

>script on
Start of a transcript of:

Detective Afonzo and The Cult of La Mancha
An Interactive Fiction by Alien Cat Studios
Release 1 / Serial number 260525 / Inform 7 v10.1.2 / D
Inform 7 v10.1.2
Identification number: //3F4AAB80-A3D7-4E51-8CD6-97F45F8917F6//
Interpreter version 0.6.1 / VM 3.1.3
Hiding Under version 4 by Eric Eve

>show me
What do you want to show yourself?

>showme
Office - room
    yourself - person
    desk - supporter
        doctor's note
        old newspaper
        tablet
    closet - closed container
        *pile of paper
        *NSFW Magazine
    rack - supporter
        green hat - hat
        red hat - hat
        black hat - hat
        tiara - hat
        trophy
* denotes things which are not in scope

* * *

You wake up from a quick nap in your office. You look around - you clearly haven't cleaned it in a while. How could you, with the biggest case you've ever faced still unsolved?

Detective Afonzo and The Cult of La Mancha
An Interactive Fiction by Alien Cat Studios
Release 1 / Serial number 260530 / Inform 7 v10.1.2 / D

Office
 My dusty old office, I've solved so many crimes here... but none like the mystery im facing now.

You can see a desk, a closet (closed) and a rack (on which are a green hat, a red hat, a black hat, a tiara and a trophy) here.

>take tiara
Taken.

>wear tiara
Nobody can question my fashion! I will walk out with a tiara if I want!

>investigate trophy
I am investigating this case. I don't investigate objects or people. I examine them. Let us not stain the true work of a detective.

>investigate trophy
I already said this. I examine things, I don't investigate. Do not test my patience, player.

>investigate trophy
You are very persistent and annoying. Stop trying to investigate things. The command is to examine things. Stop insisting.

>investigate trophy
Ok you know what. Fine. You win. I will investigate this. You don't need to examine anything ever again. But just because of that, I'm throwing everything in the inventory away so you can never see it again, you smarty-pants. Fool.

I was so good at Mark Kart 64... winning this tournament was a breeze!

>inventory
You are carrying nothing.

* * *

You wake up from a quick nap in your office. You look around - you clearly haven't cleaned it in a while. How could you, with the biggest case you've ever faced still unsolved?

Detective Afonzo and The Cult of La Mancha
An Interactive Fiction by Alien Cat Studios
Release 1 / Serial number 260530 / Inform 7 v10.1.2 / D

Office
 My dusty old office, I've solved so many crimes here... but none like the mystery im facing now.

You can see a desk, a closet (closed) and a rack (on which are a green hat, a red hat, a black hat, a tiara and a trophy) here.

>think
I should check my current cases.

>open closet
What a mess... well, look what we have here... this pile of paper has my current cases, and it's piling up... I should take a look at these.

>read cases
The first case happened a week ago... they were found dead in a trash can. According to the police report, they had very peculiar injuries... it looks like they fought with the attacker.
As for the second case, it was just delivered to me. The body is still in the courthouse, so I should head there soon. Judge Richard was found dead in his chambers found with a knife in his head. A judge can get a lot of enemies, but he was only working on one case at the time... I should go there.

>think
I must head out to investigate Judge Richard's murder.

>leave
It's chilly outside. I should probably wear a hat.

>think
I think my hats are on the rack. Just taking one isn't enough, I need to actually wear it.

>wear tiara
(first taking the tiara)
Nobody can question my fashion! I will walk out with a tiara if I want!

>leave
The 68th Street
68th Street looks as busy, noisy and smelly as usual. Cars are flying around, ads cover every screen, and people walk and move around in their trendy clothes like ants going to and from their home colonies, living their happy lives mindlessly.

Both murders happened in another part of the town, I think have to go east.

>think
I should visit Judge Richard's chambers to investigate his murder.

>go e
St Miku Crossing
St. Miku Crossing, the epitome of modern city living, a sea of people surrounded by cars, shops and buildings as tall as the eye can see, piercing the clouds above like a knife.

I see the Justice Avenue to the South, as well as the 68th Street to the West.

>think
I should visit Judge Richard's chambers to investigate his murder.

>go south
Justice Avenue
Justice Avenue looks as tidy as ever, it's the home of the city's rich and powerful, where the oligarchs and polititians come together to scheme whatever greedy plans they have... and they call it Justice, heh.

The ads here are different, instead of the newest movies and products, it's fine dining and jewelry. Even the people look different, the neon bright colors are now replaced by more sublte, darker tones, the hoodies turn to suits and ties and the smiles to stone cold expressions.

They don't even notice me walk by.

There's multiple ways to go from here, east, to the Daniel Louis-Campbell Park, to the south where the El Court" Americano is and to the west, towards Bingo Street.

You can see a closed park gate that leads to the Daniel Louis-Campbell Park. and Mike here.

>think
I should visit Judge Richard's chambers to investigate his murder.

>s
El Court" Americano - Main Hall
I've always loved the look of this place, it's like a beacon of life in the middle of a sea of gray concrete mediocrity. It's a massive square entrance with big glass doors that let the sunshine come in during the day.

The architecture of it somehow strikes a perfect balance between between classic, roman-inspired designs and a smooth, minimalism-heavy futuristic style.

People are walking all over the place with books in their hands, phones in their ears or holding their bags while sprinting somewhere as if they're late. I doubt any of them would talk.

On the far end of the room there's a big reception area, with three spots for receptionists to welcome in visitors and guide them to where they need to go though, at this time, there's only one present, and she looks free to talk to, maybe i could talk to her.

There's something strange to the East, i can see a small door almost completly covered by a group of plants leaning over to it, like they we're placed there to hide it.

You can see a receptionist here.

>think
I should visit Judge Richard's chambers to investigate his murder.

* * *

>think
I should check my current cases.

>think
What a good idea.