Start of a transcript of:

Detective Afonzo and The Cult of La Mancha
An Interactive Fiction by Alien Cat Studios
Release 1 / Serial number 260525 / Inform 7 v10.1.2 / D
Inform 7 v10.1.2
Identification number: //3F4AAB80-A3D7-4E51-8CD6-97F45F8917F6//
Interpreter version 0.6.1 / VM 3.1.3
Hiding Under version 4 by Eric Eve

>open closet
What a mess... well, look what we have here... this pile of paper has my current cases, and it's piling up... I should take a look at these.

>examine paper
There are 2 cases here. Another couple just like my parents, found in Bingo Street... and a judge killed in his own chambers. He was working on some case about a cosmetics company.

>go Bingo Street
You can't see any such thing.

>go n
I could leave, but to where? I should probably read my cases first.

>read cases
You can't see any such thing.

>read paper
The first case happened a week ago... they were found dead in a trash can. According to the police report, they had very peculiar injuries... it looks like they fought with the attacker.
As for the second case, it was just delivered to me. The body is still in the courthouse, so I should head there soon. Judge Richard was found dead in his chambers found with a knife in his head. A judge can get a lot of enemies, but he was only working on one case at the time... I should go there.

>go chambers
You can't see any such thing.

>leave
It's chilly outside. I should probably wear a hat.

>back
That's not a verb I recognise.

>pick hat
I didn't understand that sentence.

>grab hat
That's not a verb I recognise.

>go rack
That's not something you can enter.

>open rack
It isn't something you can open.

>grab rack
That's not a verb I recognise.

>examine rack
All of my hats are here, and my trophy as well.

On the rack are a green hat, a red hat, a black hat, a tiara and a trophy.

>examine green hat
This hat is perfect for St. Patrick celebrations.

>use green hat
That's not a verb I recognise.

>pick up green hat
Taken.

>leave
It's chilly outside. I should probably wear a hat.

>where
That's not a verb I recognise.

>weare
That's not a verb I recognise.

>wear
(the green hat)
High fashion for Alfonzo Sapienze! This looks good on me.

>leave

The 68th Street
68th Street looks as busy, noisy and smelly as usual. Cars are flying around, ads cover every screen, and people walk and move around in their trendy clothes like ants going to and from their home colonies, living their happy lives mindlessly.

Both murders happened in another part of the town, I think have to go east.

>e

St Miku Crossing
St. Miku Crossing, the epitome of modern city living, a sea of people surrounded by cars, shops and buildings as tall as the eye can see, piercing the clouds above like a knife.

I see the Justice Avenue to the South, as well as the 68th Street to the West.

>w

The 68th Street
68th Street looks as busy, noisy and smelly as usual. Cars are flying around, ads cover every screen, and people walk and move around in their trendy clothes like ants going to and from their home colonies, living their happy lives mindlessly.

Both murders happened in another part of the town, I think have to go east.

>e

St Miku Crossing
St. Miku Crossing, the epitome of modern city living, a sea of people surrounded by cars, shops and buildings as tall as the eye can see, piercing the clouds above like a knife.

I see the Justice Avenue to the South, as well as the 68th Street to the West.

>e
You can't go that way.

>w

The 68th Street
68th Street looks as busy, noisy and smelly as usual. Cars are flying around, ads cover every screen, and people walk and move around in their trendy clothes like ants going to and from their home colonies, living their happy lives mindlessly.

Both murders happened in another part of the town, I think have to go east.

>e

St Miku Crossing
St. Miku Crossing, the epitome of modern city living, a sea of people surrounded by cars, shops and buildings as tall as the eye can see, piercing the clouds above like a knife.

I see the Justice Avenue to the South, as well as the 68th Street to the West.

>n
You can't go that way.

>s

Justice Avenue
Justice Avenue looks as tidy as ever, it's the home of the city's rich and powerful, where the oligarchs and polititians come together to scheme whatever greedy plans they have... and they call it Justice, heh.

The ads here are different, instead of the newest movies and products, it's fine dining and jewelry. Even the people look different, the neon bright colors are now replaced by more sublte, darker tones, the hoodies turn to suits and ties and the smiles to stone cold expressions.

They don't even notice me walk by.

There's multiple ways to go from here, east, to the Daniel Louis-Campbell Park, to the south where the El Court" Americano is and to the west, towards Bingo Street.

You can see a closed park gate that leads to the Daniel Louis-Campbell Park. and Mike here.

>talk to Mike
"I wanted to see the small ducks, but they are under construction..."
...
"I mean the park, not the ducks!
Oh. Ok... I'm just gonna go now...
"Oh ok Mr. High-And-Mighty-Normal-Hat-Wearer. Could at least wear something cool like a tiara!"

>w

Bingo Street
Bingo Street is like a louder, more run down version of 68th Street, if that's even possible. The atmosphere feels similar, but the people don't, they feel more like the ones on Justice Avenue, only without all the money.

The cops don't usually come here, they're paid well not to... damn bastards.

For some reason they decided to build a damn company here, i'd go in but the place is in repairs from what it looks like, about time if ya ask me, thought it'd be better if the people got that treatment first, it's been needed for a long ass time.

>n
You can't go that way.

>e

Justice Avenue
Justice Avenue looks as tidy as ever, it's the home of the city's rich and powerful, where the oligarchs and polititians come together to scheme whatever greedy plans they have... and they call it Justice, heh.

The ads here are different, instead of the newest movies and products, it's fine dining and jewelry. Even the people look different, the neon bright colors are now replaced by more sublte, darker tones, the hoodies turn to suits and ties and the smiles to stone cold expressions.

They don't even notice me walk by.

There's multiple ways to go from here, east, to the Daniel Louis-Campbell Park, to the south where the El Court" Americano is and to the west, towards Bingo Street.

You can see a closed park gate that leads to the Daniel Louis-Campbell Park. and Mike here.

>open park gate
It's still under construction...

>go n

St Miku Crossing
St. Miku Crossing, the epitome of modern city living, a sea of people surrounded by cars, shops and buildings as tall as the eye can see, piercing the clouds above like a knife.

I see the Justice Avenue to the South, as well as the 68th Street to the West.

>
I beg your pardon?

>w

The 68th Street
68th Street looks as busy, noisy and smelly as usual. Cars are flying around, ads cover every screen, and people walk and move around in their trendy clothes like ants going to and from their home colonies, living their happy lives mindlessly.

Both murders happened in another part of the town, I think have to go east.

>e

St Miku Crossing
St. Miku Crossing, the epitome of modern city living, a sea of people surrounded by cars, shops and buildings as tall as the eye can see, piercing the clouds above like a knife.

I see the Justice Avenue to the South, as well as the 68th Street to the West.

>w

The 68th Street
68th Street looks as busy, noisy and smelly as usual. Cars are flying around, ads cover every screen, and people walk and move around in their trendy clothes like ants going to and from their home colonies, living their happy lives mindlessly.

Both murders happened in another part of the town, I think have to go east.

>w
You can't go that way.

>n
You can't go that way.

>s
You can't go that way.

>e

St Miku Crossing
St. Miku Crossing, the epitome of modern city living, a sea of people surrounded by cars, shops and buildings as tall as the eye can see, piercing the clouds above like a knife.

I see the Justice Avenue to the South, as well as the 68th Street to the West.

>w

The 68th Street
68th Street looks as busy, noisy and smelly as usual. Cars are flying around, ads cover every screen, and people walk and move around in their trendy clothes like ants going to and from their home colonies, living their happy lives mindlessly.

Both murders happened in another part of the town, I think have to go east.

>e

St Miku Crossing
St. Miku Crossing, the epitome of modern city living, a sea of people surrounded by cars, shops and buildings as tall as the eye can see, piercing the clouds above like a knife.

I see the Justice Avenue to the South, as well as the 68th Street to the West.

>s

Justice Avenue
Justice Avenue looks as tidy as ever, it's the home of the city's rich and powerful, where the oligarchs and polititians come together to scheme whatever greedy plans they have... and they call it Justice, heh.

The ads here are different, instead of the newest movies and products, it's fine dining and jewelry. Even the people look different, the neon bright colors are now replaced by more sublte, darker tones, the hoodies turn to suits and ties and the smiles to stone cold expressions.

They don't even notice me walk by.

There's multiple ways to go from here, east, to the Daniel Louis-Campbell Park, to the south where the El Court" Americano is and to the west, towards Bingo Street.

You can see a closed park gate that leads to the Daniel Louis-Campbell Park. and Mike here.

>w

Bingo Street
Bingo Street is like a louder, more run down version of 68th Street, if that's even possible. The atmosphere feels similar, but the people don't, they feel more like the ones on Justice Avenue, only without all the money.

The cops don't usually come here, they're paid well not to... damn bastards.

For some reason they decided to build a damn company here, i'd go in but the place is in repairs from what it looks like, about time if ya ask me, thought it'd be better if the people got that treatment first, it's been needed for a long ass time.

>e

Justice Avenue
Justice Avenue looks as tidy as ever, it's the home of the city's rich and powerful, where the oligarchs and polititians come together to scheme whatever greedy plans they have... and they call it Justice, heh.

The ads here are different, instead of the newest movies and products, it's fine dining and jewelry. Even the people look different, the neon bright colors are now replaced by more sublte, darker tones, the hoodies turn to suits and ties and the smiles to stone cold expressions.

They don't even notice me walk by.

There's multiple ways to go from here, east, to the Daniel Louis-Campbell Park, to the south where the El Court" Americano is and to the west, towards Bingo Street.

You can see a closed park gate that leads to the Daniel Louis-Campbell Park. and Mike here.

>s

El Court" Americano - Main Hall
I've always loved the look of this place, it's like a beacon of life in the middle of a sea of gray concrete mediocrity. It's a massive square entrance with big glass doors that let the sunshine come in during the day.

The architecture of it somehow strikes a perfect balance between between classic, roman-inspired designs and a smooth, minimalism-heavy futuristic style.

People are walking all over the place with books in their hands, phones in their ears or holding their bags while sprinting somewhere as if they're late. I doubt any of them would talk.

On the far end of the room there's a big reception area, with three spots for receptionists to welcome in visitors and guide them to where they need to go though, at this time, there's only one present, and she looks free to talk to, maybe i could talk to her.

There's something strange to the East, i can see a small door almost completly covered by a group of plants leaning over to it, like they we're placed there to hide it.

You can see a receptionist here.

>examine receptionist
This lady seems competent. And she is typing so fast too. And cute too. Maybe I can ask her out on a date after I solve this case.

>talk to lady
Hello, may I know where Judge Richard's chambers are?
"I'm sorry, but he is quite busy at the moment, you need to return another day."
I am Detective Alfonzo. I was called here to investigate his death.
"My apologies... it's that room to the right."
I thought my hat would give it away...

>go right
You can't see any such thing.

>e

Suspicious Alley
The door lead to a narrow, stinking alleyway, isolated from the rest of the city.

There's rats all over and spiders crawling on the walls. There is no way to go but forwards, to the darkness.

>undo
El Court" Americano - Main Hall
[Previous turn undone.]

>go inside
>A strange man bumps into you.
Hey! Watch where you're going!
He's already gone... could have at least apologized.

El Court" Americano - Judge Richard's Office
I remember hearing about this guy from my mother... I think they worked together a couple of times...

This is one small office... looks old, older than the rest of the building, like it's holding on to a long forgotten past.

It's well kept though, despite... everything.

You can see a Fancy Desk (on which is an Open Letter), a Judge Richard's Dead Body, a Blood Stain and a Bookshelf here.

>examine fancy desk
This desk has some fine craftsmanship, suiting for a judge. Though it's starting to show it's age.

I should take a closer look at it.

On the Fancy Desk is an Open Letter.

>look fancy desk
This desk has some fine craftsmanship, suiting for a judge. Though it's starting to show it's age.

I should take a closer look at it.

On the Fancy Desk is an Open Letter.

>open letter
It isn't something you can open.

>look closely
You can't see any such thing.

>examine open letter
Hold on, this letter is in my mother's handwritting... looks like they were close, much closer than i thought.

They were working on a case together for her activism, but I can't make out the rest of it though.

>n
You can't go that way.

>e
You can't go that way.

>w
You can't go that way.

>s
You can't go that way.

>examine
(the green hat)
This hat is perfect for St. Patrick celebrations.

>examine Judge Richard's Dead Body
Poor old bastard. Stabbed in the back of the head, whoever did this wanted to make sure he didn't walk out of here alive.

The knife is missing.

>search knife
You can't see any such thing.

>examine Blood Stain
There's a trail of blood leading underneath the bookshelf.

>examine bookshelf
An old bookshelf, filled to the brim with all kinds of books and memorabilia

>go under bookshelf
You can't see any such thing.

>under
That's not a verb I recognise.

>examine underneath
You can't see any such thing.

>bookshelf
That's not a verb I recognise.

>look under bookshelf
Under the Bookshelf you find a Bloody Knife.

>pick up Bloody Knife
Taken.

>examine bloody knife
Must be the murder weapon. The blood's gone dry.

There's a symbol of a hand on the handle. The blade looks odd... now that i look at it, this kind of thing could do some real damage if handled improperly, the same kind of damage found on that couple in Bingo Street.

This thing was hiding under the bookshelf... I wonder if there are other hidden things i could find.

>look under bookshelf
You find nothing of interest.

>findo other things
That's not a verb I recognise.

>look under desk
Under the Fancy Desk you find an old key.

>examine old key
This key is familiar... where have I seen it before?

>pick up old key
A key? I wonder what I could do with this...

Taken.

>use old key
That's not a verb I recognise.

>use bloody knife
That's not a verb I recognise.

>drop bloody knife
Dropped.

>pick up bloody knife
Taken.

>exit

El Court" Americano - Main Hall
I've always loved the look of this place, it's like a beacon of life in the middle of a sea of gray concrete mediocrity. It's a massive square entrance with big glass doors that let the sunshine come in during the day.

The architecture of it somehow strikes a perfect balance between between classic, roman-inspired designs and a smooth, minimalism-heavy futuristic style.

People are walking all over the place with books in their hands, phones in their ears or holding their bags while sprinting somewhere as if they're late. I doubt any of them would talk.

On the far end of the room there's a big reception area, with three spots for receptionists to welcome in visitors and guide them to where they need to go though, at this time, there's only one present, and she looks free to talk to, maybe i could talk to her.

There's something strange to the East, i can see a small door almost completly covered by a group of plants leaning over to it, like they we're placed there to hide it.

You can see a receptionist here.

>invite lady to date
That's not a verb I recognise.

>exit 

Justice Avenue
Back in the Justice Avenue. Looks like the Park is finally open. Maybe I should go inside and look at the ducks.

You can see a closed park gate that leads to the Daniel Louis-Campbell Park. and Mike here.

>exit
But you aren't in anything at the moment.

>quit
Are you sure you want to quit? n

>scipt off
That's not a verb I recognise.

>script off

End of transcript.
