Start of a transcript of:

Detective Afonzo and The Cult of La Mancha
An Interactive Fiction by Alien Cat Studios
Release 1 / Serial number 260525 / Inform 7 v10.1.2 / D
Inform 7 v10.1.2
Identification number: //3F4AAB80-A3D7-4E51-8CD6-97F45F8917F6//
Interpreter version 0.6.1 / VM 3.1.3
Hiding Under version 4 by Eric Eve

>pick black hat
I didn't understand that sentence.

>pick up black hat
Taken.

>eat black hat
That's plainly inedible.

>open closet
What a mess... well, look what we have here... this pile of paper has my current cases, and it's piling up... I should take a look at these.

>burn paper
This dangerous act would achieve little.

>put black hat on
High fashion for Alfonzo Sapienze! This looks good on me.

>examine black hat
I look like Professor Layton now!

>take black hat out
I only understood you as far as wanting to take the black hat.

>take black hat up~
I only understood you as far as wanting to take the black hat.

>take black hat up
I only understood you as far as wanting to take the black hat.

>remove black hat
You aren't wearing the black hat.

>wear hat
(the black hat)
High fashion for Alfonzo Sapienze! This looks good on me.

>remove black hat
You aren't wearing the black hat.

>pick papers
I didn't understand that sentence.

>pick paper
I didn't understand that sentence.

>take paper
Taken.

>inv
You are carrying:
  a pile of paper
  a black hat

>examine paper
There are 2 cases here. Another couple just like my parents, found in Bingo Street... and a judge killed in his own chambers. He was working on some case about a cosmetics company.

>leave
I could leave, but to where? I should probably read my cases first.

>read case
You can't see any such thing.

>read cases
You can't see any such thing.

>read paper
The first case happened a week ago... they were found dead in a trash can. According to the police report, they had very peculiar injuries... it looks like they fought with the attacker.
As for the second case, it was just delivered to me. The body is still in the courthouse, so I should head there soon. Judge Richard was found dead in his chambers found with a knife in his head. A judge can get a lot of enemies, but he was only working on one case at the time... I should go there.

>examine paper
There are 2 cases here. Another couple just like my parents, found in Bingo Street... and a judge killed in his own chambers. He was working on some case about a cosmetics company.

>look paper
There are 2 cases here. Another couple just like my parents, found in Bingo Street... and a judge killed in his own chambers. He was working on some case about a cosmetics company.

>investigate paper
That's not a verb I recognise.

>leave

The 68th Street
68th Street looks as busy, noisy and smelly as usual. Cars are flying around, ads cover every screen, and people walk and move around in their trendy clothes like ants going to and from their home colonies, living their happy lives mindlessly.

Both murders happened in another part of the town, I think have to go east.

>east

St Miku Crossing
St. Miku Crossing, the epitome of modern city living, a sea of people surrounded by cars, shops and buildings as tall as the eye can see, piercing the clouds above like a knife.

I see the Justice Avenue to the South, as well as the 68th Street to the West.

>enter justice avenue~
You can't see any such thing.

>enter justice avenue
You can't see any such thing.

>go south

Justice Avenue
Justice Avenue looks as tidy as ever, it's the home of the city's rich and powerful, where the oligarchs and polititians come together to scheme whatever greedy plans they have... and they call it Justice, heh.

The ads here are different, instead of the newest movies and products, it's fine dining and jewelry. Even the people look different, the neon bright colors are now replaced by more sublte, darker tones, the hoodies turn to suits and ties and the smiles to stone cold expressions.

They don't even notice me walk by.

There's multiple ways to go from here, east, to the Daniel Louis-Campbell Park, to the south where the El Court" Americano is and to the west, towards Bingo Street.

You can see a closed park gate that leads to the Daniel Louis-Campbell Park. and Mike here.

>open gate
It's still under construction...

>destroy gate
Violence isn't the answer to this one.

>kick gate
That's not a verb I recognise.

>read ads
You can't see any such thing.

>examine ads
You can't see any such thing.

>talk person~
I didn't understand that sentence.

>talk~
That's not a verb I recognise.

>talk
(to Mike)
"I wanted to see the small ducks, but they are under construction..."
...
"I mean the park, not the ducks!
Oh. Ok... I'm just gonna go now...
"Oh ok Mr. High-And-Mighty-Normal-Hat-Wearer. Could at least wear something cool like a tiara!"

>shut up
You must name something more substantial.

>shut up mike
He isn't something you can close.

>punch mike
Violence isn't the answer to this one.

>talk mike
I didn't understand that sentence.

>leave
But you aren't in anything at the moment.

>go n

St Miku Crossing
St. Miku Crossing, the epitome of modern city living, a sea of people surrounded by cars, shops and buildings as tall as the eye can see, piercing the clouds above like a knife.

I see the Justice Avenue to the South, as well as the 68th Street to the West.

>go w

The 68th Street
68th Street looks as busy, noisy and smelly as usual. Cars are flying around, ads cover every screen, and people walk and move around in their trendy clothes like ants going to and from their home colonies, living their happy lives mindlessly.

Both murders happened in another part of the town, I think have to go east.

>go e

St Miku Crossing
St. Miku Crossing, the epitome of modern city living, a sea of people surrounded by cars, shops and buildings as tall as the eye can see, piercing the clouds above like a knife.

I see the Justice Avenue to the South, as well as the 68th Street to the West.

>go home
You can't see any such thing.

>go e
You can't go that way.

>go w

The 68th Street
68th Street looks as busy, noisy and smelly as usual. Cars are flying around, ads cover every screen, and people walk and move around in their trendy clothes like ants going to and from their home colonies, living their happy lives mindlessly.

Both murders happened in another part of the town, I think have to go east.

>examine car
You can't see any such thing.

>go e

St Miku Crossing
St. Miku Crossing, the epitome of modern city living, a sea of people surrounded by cars, shops and buildings as tall as the eye can see, piercing the clouds above like a knife.

I see the Justice Avenue to the South, as well as the 68th Street to the West.

>go e
You can't go that way.

>go n
You can't go that way.

>go s

Justice Avenue
Justice Avenue looks as tidy as ever, it's the home of the city's rich and powerful, where the oligarchs and polititians come together to scheme whatever greedy plans they have... and they call it Justice, heh.

The ads here are different, instead of the newest movies and products, it's fine dining and jewelry. Even the people look different, the neon bright colors are now replaced by more sublte, darker tones, the hoodies turn to suits and ties and the smiles to stone cold expressions.

They don't even notice me walk by.

There's multiple ways to go from here, east, to the Daniel Louis-Campbell Park, to the south where the El Court" Americano is and to the west, towards Bingo Street.

You can see a closed park gate that leads to the Daniel Louis-Campbell Park. and Mike here.

>enter
You must supply a noun.

>go s

El Court" Americano - Main Hall
I've always loved the look of this place, it's like a beacon of life in the middle of a sea of gray concrete mediocrity. It's a massive square entrance with big glass doors that let the sunshine come in during the day.

The architecture of it somehow strikes a perfect balance between between classic, roman-inspired designs and a smooth, minimalism-heavy futuristic style.

People are walking all over the place with books in their hands, phones in their ears or holding their bags while sprinting somewhere as if they're late. I doubt any of them would talk.

On the far end of the room there's a big reception area, with three spots for receptionists to welcome in visitors and guide them to where they need to go though, at this time, there's only one present, and she looks free to talk to, maybe i could talk to her.

There's something strange to the East, i can see a small door almost completly covered by a group of plants leaning over to it, like they we're placed there to hide it.

You can see a receptionist here.

>inv
You are carrying:
  a pile of paper
  a black hat

>talk
(to the receptionist)
Hello, may I know where Judge Richard's chambers are?
"I'm sorry, but he is quite busy at the moment, you need to return another day."
I am Detective Alfonzo. I was called here to investigate his death.
"My apologies... it's that room to the right."
I thought my hat would give it away...

>go r
You can't see any such thing.

>go right
You can't see any such thing.

>go e

Suspicious Alley
The door lead to a narrow, stinking alleyway, isolated from the rest of the city.

There's rats all over and spiders crawling on the walls. There is no way to go but forwards, to the darkness.

>go w

El Court" Americano - Main Hall
I've always loved the look of this place, it's like a beacon of life in the middle of a sea of gray concrete mediocrity. It's a massive square entrance with big glass doors that let the sunshine come in during the day.

The architecture of it somehow strikes a perfect balance between between classic, roman-inspired designs and a smooth, minimalism-heavy futuristic style.

People are walking all over the place with books in their hands, phones in their ears or holding their bags while sprinting somewhere as if they're late. I doubt any of them would talk.

On the far end of the room there's a big reception area, with three spots for receptionists to welcome in visitors and guide them to where they need to go though, at this time, there's only one present, and she looks free to talk to, maybe i could talk to her.

There's something strange to the East, i can see a small door almost completly covered by a group of plants leaning over to it, like they we're placed there to hide it.

You can see a receptionist here.

>go e

Suspicious Alley
The door lead to a narrow, stinking alleyway, isolated from the rest of the city.

There's rats all over and spiders crawling on the walls. There is no way to go but forwards, to the darkness.

>take raat
You can't see any such thing.

>take rat
You can't see any such thing.

>look rat
You can't see any such thing.

>look spider
You can't see any such thing.

>go forward
You can't see any such thing.

>go inside

Tiara Palace
Of all the places i expected to find here, a damn palace is the last one. It doesn't really look like a palace, it's more like a rainbow, glittery nightclub stuck at the end of a long, narrow alleyway.

It has a small little entrance sitting at the bottom of a facade that still manages to be imposing desipite its proportions.

There's a bouncer dressed like a clown waiting at the door, it doesn't look like he's gonna let me in, not while looking like this i'm guessin".

>talk bouncer
I didn't understand that sentence.

>talk
(to yourself)
>leave

Suspicious Alley
The door lead to a narrow, stinking alleyway, isolated from the rest of the city.

There's rats all over and spiders crawling on the walls. There is no way to go but forwards, to the darkness.

>leave
But you aren't in anything at the moment.

>go w~
You can't see any such thing.

>go w

El Court" Americano - Main Hall
I've always loved the look of this place, it's like a beacon of life in the middle of a sea of gray concrete mediocrity. It's a massive square entrance with big glass doors that let the sunshine come in during the day.

The architecture of it somehow strikes a perfect balance between between classic, roman-inspired designs and a smooth, minimalism-heavy futuristic style.

People are walking all over the place with books in their hands, phones in their ears or holding their bags while sprinting somewhere as if they're late. I doubt any of them would talk.

On the far end of the room there's a big reception area, with three spots for receptionists to welcome in visitors and guide them to where they need to go though, at this time, there's only one present, and she looks free to talk to, maybe i could talk to her.

There's something strange to the East, i can see a small door almost completly covered by a group of plants leaning over to it, like they we're placed there to hide it.

You can see a receptionist here.

>go inside
>A strange man bumps into you.
Hey! Watch where you're going!
He's already gone... could have at least apologized.

El Court" Americano - Judge Richard's Office
I remember hearing about this guy from my mother... I think they worked together a couple of times...

This is one small office... looks old, older than the rest of the building, like it's holding on to a long forgotten past.

It's well kept though, despite... everything.

You can see a Fancy Desk (on which is an Open Letter), a Judge Richard's Dead Body, a Blood Stain and a Bookshelf here.

>catch man
That's not a verb I recognise.

>take man
You can't see any such thing.

>grab an
That's not a verb I recognise.

>eat body
That's plainly inedible.

>clean stain
>open letter
It isn't something you can open.

>examine letter
Hold on, this letter is in my mother's handwritting... looks like they were close, much closer than i thought.

They were working on a case together for her activism, but I can't make out the rest of it though.

>read letter
What is wrong with me... I can't read this!

>examine letter
Hold on, this letter is in my mother's handwritting... looks like they were close, much closer than i thought.

They were working on a case together for her activism, but I can't make out the rest of it though.

>examine dead body
Poor old bastard. Stabbed in the back of the head, whoever did this wanted to make sure he didn't walk out of here alive.

The knife is missing.

>knife?
That's not a verb I recognise.

>look knife
You can't see any such thing.

>take knife
You can't see any such thing.

>examine bookshelf
An old bookshelf, filled to the brim with all kinds of books and memorabilia

>look bookshelf
An old bookshelf, filled to the brim with all kinds of books and memorabilia

>inv
You are carrying:
  a pile of paper
  a black hat

>drop hat
Dropped.

>put paper on bookshelf~
Putting things on the Bookshelf would achieve nothing.

>put paper on bookshelf
Putting things on the Bookshelf would achieve nothing.

>examine body
Poor old bastard. Stabbed in the back of the head, whoever did this wanted to make sure he didn't walk out of here alive.

The knife is missing.

>leave

El Court" Americano - Main Hall
I've always loved the look of this place, it's like a beacon of life in the middle of a sea of gray concrete mediocrity. It's a massive square entrance with big glass doors that let the sunshine come in during the day.

The architecture of it somehow strikes a perfect balance between between classic, roman-inspired designs and a smooth, minimalism-heavy futuristic style.

People are walking all over the place with books in their hands, phones in their ears or holding their bags while sprinting somewhere as if they're late. I doubt any of them would talk.

On the far end of the room there's a big reception area, with three spots for receptionists to welcome in visitors and guide them to where they need to go though, at this time, there's only one present, and she looks free to talk to, maybe i could talk to her.

There's something strange to the East, i can see a small door almost completly covered by a group of plants leaning over to it, like they we're placed there to hide it.

You can see a receptionist here.

>talk 
(to the receptionist)
"The Judge was a good man. He was always fair in his trials. Why would someone kill him?..."

>go inside

El Court" Americano - Judge Richard's Office
I remember hearing about this guy from my mother... I think they worked together a couple of times...

This is one small office... looks old, older than the rest of the building, like it's holding on to a long forgotten past.

It's well kept though, despite... everything.

You can see a black hat, a Fancy Desk (on which is an Open Letter), a Judge Richard's Dead Body, a Blood Stain and a Bookshelf here.

>examine fancy desk
This desk has some fine craftsmanship, suiting for a judge. Though it's starting to show it's age.

I should take a closer look at it.

On the Fancy Desk is an Open Letter.

>take letter
Taken.

>open bookshelf
It isn't something you can open.

>examine blood
There's a trail of blood leading underneath the bookshelf.

>move bookshelf
Nothing obvious happens.

>pull book from bookshelf
You can't see any such thing.

>push bookshelf
Nothing obvious happens.

>pull bookshelg
You can't see any such thing.

>look under bookshelf~
Under the Bookshelf you find a Bloody Knife.

>take knife
Taken.

>examine knife
Must be the murder weapon. The blood's gone dry.

There's a symbol of a hand on the handle. The blade looks odd... now that i look at it, this kind of thing could do some real damage if handled improperly, the same kind of damage found on that couple in Bingo Street.

This thing was hiding under the bookshelf... I wonder if there are other hidden things i could find.

>look under bookshelf
You find nothing of interest.

>leave

El Court" Americano - Main Hall
I've always loved the look of this place, it's like a beacon of life in the middle of a sea of gray concrete mediocrity. It's a massive square entrance with big glass doors that let the sunshine come in during the day.

The architecture of it somehow strikes a perfect balance between between classic, roman-inspired designs and a smooth, minimalism-heavy futuristic style.

People are walking all over the place with books in their hands, phones in their ears or holding their bags while sprinting somewhere as if they're late. I doubt any of them would talk.

On the far end of the room there's a big reception area, with three spots for receptionists to welcome in visitors and guide them to where they need to go though, at this time, there's only one present, and she looks free to talk to, maybe i could talk to her.

There's something strange to the East, i can see a small door almost completly covered by a group of plants leaning over to it, like they we're placed there to hide it.

You can see a receptionist here.

>kill receptionist
Violence isn't the answer to this one.

>throw knife at receptionist
You lack the nerve when it comes to the crucial moment.

>throw knife 
Dropped.

>east

Suspicious Alley
The door lead to a narrow, stinking alleyway, isolated from the rest of the city.

There's rats all over and spiders crawling on the walls. There is no way to go but forwards, to the darkness.

>go west~
You can't see any such thing.

>go west

El Court" Americano - Main Hall
I've always loved the look of this place, it's like a beacon of life in the middle of a sea of gray concrete mediocrity. It's a massive square entrance with big glass doors that let the sunshine come in during the day.

The architecture of it somehow strikes a perfect balance between between classic, roman-inspired designs and a smooth, minimalism-heavy futuristic style.

People are walking all over the place with books in their hands, phones in their ears or holding their bags while sprinting somewhere as if they're late. I doubt any of them would talk.

On the far end of the room there's a big reception area, with three spots for receptionists to welcome in visitors and guide them to where they need to go though, at this time, there's only one present, and she looks free to talk to, maybe i could talk to her.

There's something strange to the East, i can see a small door almost completly covered by a group of plants leaning over to it, like they we're placed there to hide it.

You can see a Bloody Knife and a receptionist here.

>go inside

El Court" Americano - Judge Richard's Office
I remember hearing about this guy from my mother... I think they worked together a couple of times...

This is one small office... looks old, older than the rest of the building, like it's holding on to a long forgotten past.

It's well kept though, despite... everything.

You can see a black hat, a Fancy Desk, a Judge Richard's Dead Body, a Blood Stain and a Bookshelf here.

>look under desk
Under the Fancy Desk you find an old key.

>grab key
That's not a verb I recognise.

>take key
A key? I wonder what I could do with this...

Taken.

>examine key
This key is familiar... where have I seen it before?

>leave

El Court" Americano - Main Hall
I've always loved the look of this place, it's like a beacon of life in the middle of a sea of gray concrete mediocrity. It's a massive square entrance with big glass doors that let the sunshine come in during the day.

The architecture of it somehow strikes a perfect balance between between classic, roman-inspired designs and a smooth, minimalism-heavy futuristic style.

People are walking all over the place with books in their hands, phones in their ears or holding their bags while sprinting somewhere as if they're late. I doubt any of them would talk.

On the far end of the room there's a big reception area, with three spots for receptionists to welcome in visitors and guide them to where they need to go though, at this time, there's only one present, and she looks free to talk to, maybe i could talk to her.

There's something strange to the East, i can see a small door almost completly covered by a group of plants leaning over to it, like they we're placed there to hide it.

You can see a Bloody Knife and a receptionist here.

>leave

Justice Avenue
Back in the Justice Avenue. Looks like the Park is finally open. Maybe I should go inside and look at the ducks.

You can see a closed park gate that leads to the Daniel Louis-Campbell Park. and Mike here.

>go inside

El Court" Americano - Main Hall
I've always loved the look of this place, it's like a beacon of life in the middle of a sea of gray concrete mediocrity. It's a massive square entrance with big glass doors that let the sunshine come in during the day.

The architecture of it somehow strikes a perfect balance between between classic, roman-inspired designs and a smooth, minimalism-heavy futuristic style.

People are walking all over the place with books in their hands, phones in their ears or holding their bags while sprinting somewhere as if they're late. I doubt any of them would talk.

On the far end of the room there's a big reception area, with three spots for receptionists to welcome in visitors and guide them to where they need to go though, at this time, there's only one present, and she looks free to talk to, maybe i could talk to her.

There's something strange to the East, i can see a small door almost completly covered by a group of plants leaning over to it, like they we're placed there to hide it.

You can see a Bloody Knife and a receptionist here.

>look ducks
You can't see any such thing.

>talk
(to the receptionist)
"The Judge was a good man. He was always fair in his trials. Why would someone kill him?..."

>leave

Justice Avenue
Back in the Justice Avenue. Looks like the Park is finally open. Maybe I should go inside and look at the ducks.

You can see a closed park gate that leads to the Daniel Louis-Campbell Park. and Mike here.

>talk
(to Mike)
"I can finally see the ducks! I'm so excited to finally enter the DLC Park!"

>talk
(to Mike)
"I can finally see the ducks! I'm so excited to finally enter the DLC Park!"

>open park
That's already open.

>go parl
You can't see any such thing.

>go park

Daniel Louis-Campbell Park
I used to come here as a kid, there was a playground further in where mom and dad used to play catch with me.

Looks like there is a lake here. So pretty.

You can see a closed park gate that leads to the Daniel Louis-Campbell Park. and a lake here.

>open park gate
That's already open.

>swim
That's not a verb I recognise.

>go inside
You can't go that way.

>go lake
That's not something you can enter.

>examine lake
Such a pretty lake, and the ducks are sweet too. I remember throwing stones at the lake to see how many times it would rebound. I don't have any stones, but I have a key...

>throw key at lake
Oh. It sunk immediatly. Oops.

>grab key
That's not a verb I recognise.

>throw myself
You lack the dexterity.

>go n
You can't go that way.

>go w

Justice Avenue
Back in the Justice Avenue. Looks like the Park is finally open. Maybe I should go inside and look at the ducks.

You can see a closed park gate that leads to the Daniel Louis-Campbell Park. and Mike here.

>go e

Daniel Louis-Campbell Park
I used to come here as a kid, there was a playground further in where mom and dad used to play catch with me.

Looks like there is a lake here. So pretty.

You can see a closed park gate that leads to the Daniel Louis-Campbell Park. and a lake here.

>go inside
You can't go that way.

>go park

Justice Avenue
Back in the Justice Avenue. Looks like the Park is finally open. Maybe I should go inside and look at the ducks.

You can see a closed park gate that leads to the Daniel Louis-Campbell Park. and Mike here.

>e

Daniel Louis-Campbell Park
I used to come here as a kid, there was a playground further in where mom and dad used to play catch with me.

Looks like there is a lake here. So pretty.

You can see a closed park gate that leads to the Daniel Louis-Campbell Park. and a lake here.

>e

Afonso Sapienze's Parent's Apartment

>kill
What do you want to kill?

>myself
Violence isn't the answer to this one.

>look
Afonso Sapienze's Parent's Apartment

>go n
You can't go that way.

>
I beg your pardon?

>
I beg your pardon?

>talk
(to yourself)
>open safe with key
You can't see any such thing.

>unlock safe with key
You can't see any such thing.

>examine locked safe
You can't see any such thing.

>script off

End of transcript.
